1.333E-12, 1.335E-12, 1.338E-12, 1.341E-12, 1.346E-12, 1.363E-12, 1.370E-12, 1.378E-12, 1.386E-12, 1.394E-12, 1.404E-12, 1.413E-12, 1.421E-12, 1.430E-12, 1.438E-12, 1.420E-12, 1.426E-12, 1.433E-12, 1.441E-12, 1.451E-12, 1.463E-12, 1.478E-12, 1.496E-12, 1.516E-12, 1.537E-12, 1.556E-12, 1.571E-12, 1.583E-12, 1.591E-12, 1.596E-12, 1.598E-12, 1.599E-12, 1.599E-12, 1.598E-12, 1.596E-12, 1.594E-12, 1.601E-12, 1.597E-12, 1.593E-12, 1.578E-12, 1.573E-12, 1.567E-12, 1.559E-12, 1.552E-12, 1.545E-12, 1.537E-12, 1.534E-12, 1.526E-12, 1.517E-12, 1.508E-12, 1.499E-12, 1.489E-12, 1.480E-12, 1.509E-12, 1.503E-12, 1.495E-12, 1.487E-12, 1.476E-12, 1.463E-12, 1.447E-12, 1.428E-12, 1.407E-12, 1.386E-12, 1.367E-12, 1.350E-12, 1.338E-12, 1.329E-12, 1.323E-12, 1.319E-12, 1.317E-12, 1.317E-12, 1.317E-12
1.716E-12, 1.712E-12, 1.700E-12, 1.682E-12, 1.656E-12, 1.630E-12, 1.603E-12, 1.581E-12, 1.556E-12, 1.524E-12, 1.486E-12, 1.457E-12, 1.446E-12, 1.471E-12, 1.496E-12, 1.577E-12, 1.669E-12, 1.775E-12, 1.871E-12, 1.953E-12, 2.045E-12, 2.125E-12, 2.174E-12, 2.167E-12, 2.175E-12, 2.171E-12, 2.136E-12, 2.109E-12, 2.081E-12, 2.061E-12, 2.067E-12, 2.061E-12, 2.057E-12, 2.051E-12, 2.034E-12, 1.980E-12, 1.835E-12, 1.711E-12, 1.675E-12, 1.675E-12, 1.678E-12, 1.679E-12, 1.679E-12, 1.677E-12, 1.674E-12, 1.670E-12, 1.660E-12, 1.654E-12, 1.650E-12, 1.646E-12, 1.645E-12, 1.638E-12, 1.628E-12, 1.618E-12, 1.607E-12, 1.598E-12, 1.584E-12, 1.572E-12, 1.564E-12, 1.569E-12, 1.568E-12, 1.571E-12, 1.588E-12, 1.650E-12, 1.697E-12, 1.708E-12, 1.711E-12, 1.713E-12, 1.715E-12, 1.721E-12, 1.720E-12, 1.718E-12
2.121E-12, 2.062E-12, 2.015E-12, 1.963E-12, 1.929E-12, 1.908E-12, 1.889E-12, 1.828E-12, 1.796E-12, 1.781E-12, 1.784E-12, 1.770E-12, 1.762E-12, 1.766E-12, 1.780E-12, 1.785E-12, 1.798E-12, 1.838E-12, 1.904E-12, 1.946E-12, 1.994E-12, 2.042E-12, 2.090E-12, 2.081E-12, 2.076E-12, 2.025E-12, 1.997E-12, 1.968E-12, 1.905E-12, 1.832E-12, 1.757E-12, 1.698E-12, 1.620E-12, 1.636E-12, 1.648E-12, 1.713E-12, 1.729E-12, 1.727E-12, 1.718E-12, 1.692E-12, 1.632E-12, 1.586E-12, 1.550E-12, 1.533E-12, 1.535E-12, 1.555E-12, 1.580E-12, 1.622E-12, 1.611E-12, 1.633E-12, 1.685E-12, 1.696E-12, 1.696E-12, 1.697E-12, 1.700E-12, 1.748E-12, 1.794E-12, 1.810E-12, 1.837E-12, 1.893E-12, 1.935E-12, 1.921E-12, 1.934E-12, 1.936E-12, 1.937E-12, 1.966E-12, 2.085E-12, 2.178E-12, 2.181E-12, 2.158E-12, 2.145E-12, 2.144E-12
2.665E-12, 2.650E-12, 2.645E-12, 2.629E-12, 2.618E-12, 2.644E-12, 2.661E-12, 2.654E-12, 2.630E-12, 2.570E-12, 2.505E-12, 2.457E-12, 2.247E-12, 2.208E-12, 2.206E-12, 2.202E-12, 2.166E-12, 2.156E-12, 2.163E-12, 2.350E-12, 2.541E-12, 2.552E-12, 2.576E-12, 2.585E-12, 2.515E-12, 2.446E-12, 2.396E-12, 2.346E-12, 2.295E-12, 2.249E-12, 2.159E-12, 2.063E-12, 2.070E-12, 2.162E-12, 2.256E-12, 2.261E-12, 2.263E-12, 2.278E-12, 2.268E-12, 2.274E-12, 2.369E-12, 2.457E-12, 2.458E-12, 2.445E-12, 2.384E-12, 2.328E-12, 2.236E-12, 2.292E-12, 2.510E-12, 2.569E-12, 2.602E-12, 2.593E-12, 2.587E-12, 2.589E-12, 2.645E-12, 2.694E-12, 2.694E-12, 2.704E-12, 2.755E-12, 2.789E-12, 2.919E-12, 3.046E-12, 3.106E-12, 2.998E-12, 2.905E-12, 2.908E-12, 2.923E-12, 3.014E-12, 3.003E-12, 2.969E-12, 2.885E-12, 2.774E-12
3.277E-12, 3.269E-12, 3.252E-12, 3.211E-12, 3.236E-12, 3.322E-12, 3.419E-12, 3.569E-12, 3.717E-12, 3.705E-12, 3.701E-12, 3.410E-12, 3.087E-12, 3.099E-12, 3.141E-12, 3.133E-12, 3.004E-12, 2.767E-12, 2.617E-12, 2.634E-12, 2.756E-12, 2.879E-12, 2.889E-12, 3.017E-12, 3.012E-12, 2.975E-12, 2.946E-12, 2.912E-12, 2.939E-12, 3.032E-12, 3.145E-12, 3.143E-12, 2.872E-12, 2.941E-12, 3.770E-12, 4.111E-12, 5.031E-12, 4.853E-12, 3.637E-12, 3.426E-12, 3.109E-12, 3.040E-12, 3.099E-12, 3.048E-12, 2.983E-12, 2.997E-12, 3.163E-12, 3.620E-12, 4.036E-12, 3.925E-12, 3.754E-12, 3.572E-12, 3.383E-12, 3.173E-12, 3.122E-12, 3.128E-12, 3.127E-12, 3.165E-12, 3.251E-12, 3.445E-12, 3.433E-12, 3.442E-12, 3.354E-12, 3.351E-12, 3.354E-12, 3.369E-12, 3.392E-12, 3.432E-12, 3.408E-12, 3.369E-12, 3.327E-12, 3.329E-12
3.393E-12, 3.398E-12, 3.580E-12, 3.760E-12, 3.897E-12, 4.103E-12, 4.296E-12, 4.254E-12, 4.238E-12, 4.362E-12, 4.308E-12, 4.203E-12, 4.003E-12, 3.836E-12, 3.746E-12, 3.713E-12, 3.734E-12, 4.019E-12, 4.102E-12, 4.083E-12, 3.722E-12, 3.714E-12, 3.403E-12, 3.166E-12, 3.431E-12, 3.651E-12, 3.694E-12, 3.669E-12, 3.586E-12, 3.431E-12, 3.275E-12, 3.112E-12, 3.099E-12, 3.776E-12, 4.670E-12, 5.366E-12, 5.038E-12, 4.931E-12, 4.931E-12, 4.420E-12, 3.890E-12, 4.243E-12, 4.264E-12, 4.228E-12, 3.804E-12, 3.646E-12, 3.652E-12, 3.487E-12, 3.473E-12, 3.449E-12, 3.455E-12, 3.599E-12, 3.714E-12, 3.612E-12, 3.674E-12, 3.832E-12, 3.839E-12, 3.939E-12, 3.932E-12, 3.818E-12, 3.758E-12, 3.946E-12, 4.010E-12, 4.076E-12, 3.900E-12, 3.754E-12, 3.835E-12, 3.823E-12, 3.813E-12, 3.835E-12, 3.835E-12, 3.644E-12
4.169E-12, 5.051E-12, 6.000E-12, 6.399E-12, 7.090E-12, 7.237E-12, 7.047E-12, 5.849E-12, 6.100E-12, 5.488E-12, 4.945E-12, 5.286E-12, 5.356E-12, 5.186E-12, 4.828E-12, 4.397E-12, 4.320E-12, 4.531E-12, 4.681E-12, 4.329E-12, 4.042E-12, 3.748E-12, 3.764E-12, 3.882E-12, 3.888E-12, 3.854E-12, 3.867E-12, 3.805E-12, 3.710E-12, 3.647E-12, 3.544E-12, 3.655E-12, 4.296E-12, 5.429E-12, 6.079E-12, 6.028E-12, 5.947E-12, 6.414E-12, 6.427E-12, 6.805E-12, 5.656E-12, 5.585E-12, 5.344E-12, 5.413E-12, 5.417E-12, 4.999E-12, 4.980E-12, 4.814E-12, 4.799E-12, 4.238E-12, 4.217E-12, 4.243E-12, 4.924E-12, 4.367E-12, 4.357E-12, 4.305E-12, 4.639E-12, 5.045E-12, 5.309E-12, 4.815E-12, 4.488E-12, 4.129E-12, 4.103E-12, 4.287E-12, 4.462E-12, 4.609E-12, 4.787E-12, 4.779E-12, 4.605E-12, 4.381E-12, 4.201E-12, 4.131E-12
5.833E-12, 5.530E-12, 5.013E-12, 5.007E-12, 5.214E-12, 5.460E-12, 5.546E-12, 5.600E-12, 5.807E-12, 6.368E-12, 7.432E-12, 6.890E-12, 6.308E-12, 5.740E-12, 5.805E-12, 5.312E-12, 4.970E-12, 4.588E-12, 4.586E-12, 4.701E-12, 4.559E-12, 4.472E-12, 4.451E-12, 4.378E-12, 4.481E-12, 4.448E-12, 4.547E-12, 4.829E-12, 5.107E-12, 5.417E-12, 5.802E-12, 8.315E-12, 9.014E-12, 8.807E-12, 8.583E-12, 9.070E-12, 8.465E-12, 8.495E-12, 7.641E-12, 7.207E-12, 7.553E-12, 7.644E-12, 7.644E-12, 7.927E-12, 8.265E-12, 8.417E-12, 6.554E-12, 1.146E-11, 6.321E-12, 6.091E-12, 6.671E-12, 7.040E-12, 6.851E-12, 7.235E-12, 7.436E-12, 7.014E-12, 6.815E-12, 6.487E-12, 6.473E-12, 6.601E-12, 7.557E-12, 6.323E-12, 6.660E-12, 6.760E-12, 6.468E-12, 5.926E-12, 5.809E-12, 5.585E-12, 5.266E-12, 5.524E-12, 5.807E-12, 5.597E-12
6.189E-12, 5.911E-12, 6.346E-12, 6.444E-12, 5.877E-12, 6.140E-12, 6.408E-12, 7.103E-12, 7.700E-12, 7.553E-12, 7.412E-12, 7.204E-12, 7.345E-12, 7.864E-12, 7.106E-12, 5.970E-12, 5.540E-12, 5.039E-12, 4.990E-12, 5.070E-12, 5.105E-12, 5.163E-12, 5.237E-12, 5.413E-12, 5.645E-12, 5.580E-12, 6.276E-12, 7.777E-12, 1.014E-11, 1.280E-11, 1.639E-11, 1.809E-11, 1.718E-11, 1.631E-11, 1.845E-11, 1.971E-11, 1.874E-11, 1.478E-11, 1.103E-11, 1.222E-11, 1.130E-11, 1.054E-11, 9.592E-12, 1.092E-11, 1.214E-11, 1.638E-11, 1.789E-11, 1.878E-11, 1.747E-11, 1.828E-11, 1.912E-11, 1.691E-11, 1.699E-11, 1.370E-11, 1.294E-11, 1.229E-11, 1.107E-11, 1.010E-11, 9.676E-12, 9.233E-12, 9.862E-12, 9.962E-12, 9.609E-12, 1.017E-11, 1.041E-11, 1.107E-11, 1.023E-11, 9.540E-12, 9.340E-12, 8.387E-12, 7.442E-12, 6.795E-12
8.343E-12, 8.692E-12, 8.365E-12, 8.214E-12, 8.583E-12, 7.732E-12, 7.178E-12, 7.508E-12, 7.958E-12, 8.350E-12, 8.045E-12, 7.616E-12, 7.312E-12, 7.176E-12, 7.409E-12, 7.285E-12, 6.934E-12, 6.318E-12, 5.926E-12, 5.777E-12, 5.738E-12, 5.746E-12, 5.537E-12, 5.313E-12, 5.513E-12, 7.273E-12, 1.075E-11, 1.315E-11, 1.288E-11, 1.784E-11, 2.389E-11, 2.400E-11, 2.561E-11, 2.450E-11, 1.786E-11, 1.834E-11, 1.701E-11, 2.026E-11, 2.256E-11, 2.014E-11, 1.928E-11, 1.952E-11, 2.374E-11, 2.185E-11, 2.728E-11, 3.396E-11, 3.373E-11, 3.386E-11, 2.970E-11, 2.487E-11, 2.402E-11, 2.073E-11, 1.973E-11, 1.805E-11, 1.328E-11, 1.183E-11, 1.294E-11, 1.247E-11, 1.159E-11, 1.120E-11, 1.203E-11, 1.325E-11, 1.389E-11, 1.170E-11, 9.796E-12, 9.352E-12, 8.643E-12, 1.038E-11, 1.040E-11, 1.044E-11, 8.801E-12, 8.846E-12
9.544E-12, 8.335E-12, 8.974E-12, 1.036E-11, 8.960E-12, 9.976E-12, 9.197E-12, 8.927E-12, 9.165E-12, 7.768E-12, 7.310E-12, 7.914E-12, 8.171E-12, 7.007E-12, 6.962E-12, 6.464E-12, 7.614E-12, 6.189E-12, 5.594E-12, 5.335E-12, 5.463E-12, 5.729E-12, 6.771E-12, 7.246E-12, 7.358E-12, 8.552E-12, 1.097E-11, 1.489E-11, 2.529E-11, 3.807E-11, 4.123E-11, 4.320E-11, 3.785E-11, 2.632E-11, 2.542E-11, 2.044E-11, 2.093E-11, 2.093E-11, 2.254E-11, 2.281E-11, 2.140E-11, 2.930E-11, 3.767E-11, 4.363E-11, 4.787E-11, 3.746E-11, 3.135E-11, 2.889E-11, 2.377E-11, 2.485E-11, 2.205E-11, 2.387E-11, 2.020E-11, 1.824E-11, 1.860E-11, 1.326E-11, 1.244E-11, 1.278E-11, 1.250E-11, 1.382E-11, 1.293E-11, 1.252E-11, 1.237E-11, 1.146E-11, 1.270E-11, 1.311E-11, 1.236E-11, 1.165E-11, 9.075E-12, 1.001E-11, 9.987E-12, 9.805E-12
1.019E-11, 1.113E-11, 1.000E-11, 1.038E-11, 9.522E-12, 9.013E-12, 8.048E-12, 7.364E-12, 7.199E-12, 6.758E-12, 6.511E-12, 6.349E-12, 6.401E-12, 7.071E-12, 6.157E-12, 5.515E-12, 5.779E-12, 6.146E-12, 6.068E-12, 1.014E-11, 1.388E-11, 1.265E-11, 1.269E-11, 1.510E-11, 1.476E-11, 1.779E-11, 2.973E-11, 4.566E-11, 5.415E-11, 6.760E-11, 6.959E-11, 5.806E-11, 4.467E-11, 3.982E-11, 3.514E-11, 3.576E-11, 3.179E-11, 2.900E-11, 2.922E-11, 3.361E-11, 3.436E-11, 3.562E-11, 5.258E-11, 5.084E-11, 4.084E-11, 4.628E-11, 3.167E-11, 2.668E-11, 2.660E-11, 2.136E-11, 2.111E-11, 2.252E-11, 1.757E-11, 1.369E-11, 1.497E-11, 1.454E-11, 1.459E-11, 1.349E-11, 1.311E-11, 1.025E-11, 9.031E-12, 8.932E-12, 8.295E-12, 9.638E-12, 8.976E-12, 1.007E-11, 1.212E-11, 1.258E-11, 1.326E-11, 1.174E-11, 1.082E-11, 9.556E-12
1.041E-11, 1.010E-11, 9.821E-12, 9.559E-12, 9.095E-12, 8.383E-12, 7.745E-12, 7.064E-12, 6.464E-12, 6.757E-12, 6.804E-12, 6.532E-12, 6.231E-12, 6.142E-12, 6.344E-12, 6.551E-12, 6.553E-12, 6.816E-12, 8.891E-12, 1.696E-11, 3.084E-11, 3.247E-11, 3.051E-11, 4.116E-11, 5.369E-11, 8.060E-11, 9.011E-11, 8.883E-11, 9.454E-11, 9.995E-11, 6.977E-11, 5.263E-11, 4.694E-11, 5.163E-11, 4.058E-11, 3.191E-11, 3.544E-11, 3.785E-11, 3.214E-11, 3.360E-11, 4.648E-11, 6.255E-11, 5.966E-11, 4.820E-11, 5.181E-11, 4.521E-11, 4.028E-11, 2.881E-11, 2.648E-11, 2.414E-11, 1.866E-11, 1.928E-11, 1.641E-11, 1.403E-11, 1.129E-11, 1.289E-11, 1.043E-11, 1.189E-11, 1.307E-11, 9.016E-12, 1.025E-11, 9.240E-12, 7.968E-12, 9.404E-12, 9.790E-12, 9.651E-12, 1.010E-11, 9.834E-12, 1.054E-11, 1.029E-11, 1.104E-11, 1.145E-11
8.414E-12, 8.923E-12, 8.492E-12, 8.284E-12, 8.230E-12, 8.278E-12, 7.422E-12, 7.377E-12, 7.290E-12, 7.877E-12, 6.909E-12, 6.185E-12, 6.200E-12, 6.505E-12, 6.506E-12, 6.685E-12, 7.817E-12, 1.260E-11, 3.148E-11, 6.416E-11, 7.068E-11, 6.625E-11, 6.023E-11, 5.491E-11, 9.846E-11, 1.349E-10, 1.421E-10, 1.845E-10, 2.052E-10, 1.210E-10, 8.742E-11, 6.158E-11, 6.144E-11, 5.264E-11, 3.720E-11, 3.586E-11, 2.791E-11, 2.377E-11, 3.899E-11, 7.222E-11, 1.754E-10, 1.345E-10, 1.161E-10, 1.179E-10, 6.123E-11, 5.029E-11, 4.929E-11, 3.282E-11, 3.071E-11, 2.695E-11, 2.138E-11, 1.941E-11, 1.379E-11, 1.282E-11, 1.217E-11, 1.187E-11, 9.889E-12, 7.549E-12, 7.749E-12, 1.127E-11, 1.306E-11, 1.138E-11, 1.300E-11, 1.526E-11, 1.755E-11, 2.383E-11, 2.280E-11, 1.792E-11, 1.380E-11, 1.094E-11, 9.899E-12, 8.334E-12
1.125E-11, 9.793E-12, 8.263E-12, 7.927E-12, 8.156E-12, 8.095E-12, 7.964E-12, 7.721E-12, 7.795E-12, 7.702E-12, 7.203E-12, 7.053E-12, 7.296E-12, 6.871E-12, 8.606E-12, 9.716E-12, 1.484E-11, 2.033E-11, 6.839E-11, 1.124E-10, 1.264E-10, 9.702E-11, 1.062E-10, 1.402E-10, 1.434E-10, 1.720E-10, 2.082E-10, 2.663E-10, 1.664E-10, 8.821E-11, 7.370E-11, 7.825E-11, 8.759E-11, 7.208E-11, 6.350E-11, 7.345E-11, 6.331E-11, 8.528E-11, 1.368E-10, 1.930E-10, 2.786E-10, 2.788E-10, 2.305E-10, 1.610E-10, 7.732E-11, 6.718E-11, 5.581E-11, 4.198E-11, 2.907E-11, 1.762E-11, 1.511E-11, 1.468E-11, 1.357E-11, 1.465E-11, 1.365E-11, 9.807E-12, 1.096E-11, 9.011E-12, 1.137E-11, 1.999E-11, 3.328E-11, 3.594E-11, 5.242E-11, 6.317E-11, 4.848E-11, 3.382E-11, 2.448E-11, 2.177E-11, 1.484E-11, 1.162E-11, 1.043E-11, 1.031E-11
9.070E-12, 7.849E-12, 7.005E-12, 7.158E-12, 7.447E-12, 7.539E-12, 7.717E-12, 7.978E-12, 7.978E-12, 8.235E-12, 8.392E-12, 8.150E-12, 8.478E-12, 9.557E-12, 1.183E-11, 1.520E-11, 2.616E-11, 5.423E-11, 1.022E-10, 2.134E-10, 2.910E-10, 2.840E-10, 2.299E-10, 1.946E-10, 1.564E-10, 1.911E-10, 2.351E-10, 2.296E-10, 2.011E-10, 1.259E-10, 9.169E-11, 9.820E-11, 1.171E-10, 7.937E-11, 8.126E-11, 1.046E-10, 1.520E-10, 1.939E-10, 3.210E-10, 4.404E-10, 4.652E-10, 4.324E-10, 2.942E-10, 1.596E-10, 1.133E-10, 4.981E-11, 3.647E-11, 3.216E-11, 2.767E-11, 2.401E-11, 1.995E-11, 1.859E-11, 1.829E-11, 1.867E-11, 1.603E-11, 1.355E-11, 1.748E-11, 1.677E-11, 2.039E-11, 2.801E-11, 3.573E-11, 5.663E-11, 8.358E-11, 1.098E-10, 9.869E-11, 6.636E-11, 4.615E-11, 3.127E-11, 1.946E-11, 1.373E-11, 1.179E-11, 1.039E-11
8.283E-12, 7.603E-12, 7.389E-12, 7.135E-12, 7.725E-12, 9.210E-12, 9.263E-12, 1.032E-11, 1.063E-11, 1.030E-11, 1.085E-11, 1.098E-11, 1.202E-11, 1.370E-11, 1.935E-11, 2.609E-11, 3.937E-11, 6.190E-11, 1.131E-10, 1.787E-10, 2.888E-10, 3.442E-10, 4.140E-10, 3.197E-10, 2.117E-10, 3.295E-10, 3.271E-10, 2.693E-10, 2.153E-10, 1.786E-10, 1.793E-10, 1.445E-10, 1.391E-10, 9.202E-11, 7.552E-11, 8.485E-11, 1.112E-10, 1.681E-10, 2.954E-10, 3.521E-10, 3.634E-10, 3.143E-10, 2.433E-10, 1.582E-10, 8.759E-11, 5.017E-11, 3.342E-11, 2.641E-11, 2.515E-11, 2.445E-11, 2.121E-11, 2.346E-11, 2.373E-11, 2.415E-11, 3.216E-11, 3.549E-11, 4.046E-11, 3.603E-11, 3.321E-11, 3.779E-11, 4.664E-11, 5.397E-11, 6.870E-11, 9.407E-11, 9.791E-11, 6.855E-11, 4.486E-11, 2.907E-11, 1.676E-11, 1.199E-11, 1.008E-11, 9.041E-12
9.225E-12, 8.730E-12, 9.615E-12, 1.072E-11, 1.162E-11, 1.299E-11, 1.478E-11, 1.615E-11, 1.661E-11, 1.575E-11, 1.477E-11, 1.449E-11, 1.632E-11, 2.058E-11, 2.570E-11, 3.430E-11, 5.006E-11, 6.779E-11, 1.315E-10, 3.055E-10, 4.429E-10, 4.187E-10, 4.836E-10, 3.663E-10, 2.752E-10, 3.288E-10, 3.008E-10, 2.605E-10, 2.101E-10, 2.108E-10, 1.858E-10, 1.579E-10, 1.406E-10, 1.216E-10, 8.260E-11, 9.447E-11, 1.231E-10, 1.782E-10, 2.270E-10, 2.634E-10, 2.709E-10, 2.235E-10, 1.738E-10, 1.407E-10, 9.114E-11, 5.474E-11, 4.332E-11, 2.684E-11, 2.238E-11, 2.343E-11, 2.751E-11, 2.694E-11, 2.812E-11, 3.364E-11, 4.368E-11, 6.089E-11, 8.785E-11, 5.771E-11, 6.369E-11, 5.931E-11, 5.320E-11, 5.934E-11, 6.475E-11, 6.031E-11, 6.253E-11, 4.021E-11, 2.123E-11, 1.473E-11, 1.154E-11, 9.815E-12, 9.043E-12, 9.207E-12
1.263E-11, 1.138E-11, 1.274E-11, 1.338E-11, 1.603E-11, 1.814E-11, 1.891E-11, 1.953E-11, 2.174E-11, 2.128E-11, 2.126E-11, 2.175E-11, 2.371E-11, 2.658E-11, 3.193E-11, 4.239E-11, 5.483E-11, 9.151E-11, 1.497E-10, 2.936E-10, 5.026E-10, 5.661E-10, 5.507E-10, 3.793E-10, 2.687E-10, 2.730E-10, 2.622E-10, 2.184E-10, 1.871E-10, 1.537E-10, 1.380E-10, 1.372E-10, 1.500E-10, 1.139E-10, 9.965E-11, 8.717E-11, 1.059E-10, 1.422E-10, 1.651E-10, 1.273E-10, 2.038E-10, 1.566E-10, 8.761E-11, 7.988E-11, 6.458E-11, 5.023E-11, 3.933E-11, 3.285E-11, 3.233E-11, 3.335E-11, 3.440E-11, 3.196E-11, 3.273E-11, 3.779E-11, 4.982E-11, 5.589E-11, 4.846E-11, 4.212E-11, 4.392E-11, 2.875E-11, 2.641E-11, 3.164E-11, 3.237E-11, 3.474E-11, 2.830E-11, 2.709E-11, 1.495E-11, 1.166E-11, 1.094E-11, 1.084E-11, 1.175E-11, 1.151E-11
1.132E-11, 1.227E-11, 1.379E-11, 1.514E-11, 1.699E-11, 1.619E-11, 1.550E-11, 1.647E-11, 1.928E-11, 1.788E-11, 1.778E-11, 2.008E-11, 2.089E-11, 2.574E-11, 2.600E-11, 3.169E-11, 3.622E-11, 5.207E-11, 8.505E-11, 1.150E-10, 1.357E-10, 1.997E-10, 1.642E-10, 8.508E-11, 6.139E-11, 7.942E-11, 8.308E-11, 8.652E-11, 9.857E-11, 8.753E-11, 9.493E-11, 1.028E-10, 8.286E-11, 8.402E-11, 7.851E-11, 6.520E-11, 7.109E-11, 9.133E-11, 6.368E-11, 1.159E-10, 1.061E-10, 9.645E-11, 6.492E-11, 5.681E-11, 3.695E-11, 4.131E-11, 3.073E-11, 3.152E-11, 2.979E-11, 2.973E-11, 2.967E-11, 3.452E-11, 3.272E-11, 4.195E-11, 3.422E-11, 3.677E-11, 3.229E-11, 2.490E-11, 2.297E-11, 1.956E-11, 2.279E-11, 3.159E-11, 2.486E-11, 1.814E-11, 1.283E-11, 1.280E-11, 1.203E-11, 1.267E-11, 1.353E-11, 1.606E-11, 1.177E-11, 1.188E-11
1.032E-11, 1.164E-11, 1.592E-11, 1.567E-11, 1.581E-11, 1.413E-11, 1.271E-11, 1.473E-11, 1.545E-11, 1.649E-11, 1.777E-11, 1.932E-11, 1.859E-11, 1.690E-11, 2.102E-11, 2.145E-11, 2.326E-11, 2.696E-11, 3.215E-11, 3.568E-11, 2.803E-11, 2.928E-11, 5.488E-11, 2.343E-11, 2.397E-11, 2.189E-11, 1.919E-11, 3.607E-11, 2.730E-11, 3.397E-11, 3.402E-11, 3.369E-11, 3.542E-11, 5.047E-11, 5.328E-11, 6.337E-11, 6.663E-11, 6.317E-11, 6.339E-11, 6.341E-11, 7.476E-11, 7.020E-11, 7.616E-11, 7.817E-11, 6.113E-11, 4.902E-11, 3.239E-11, 3.430E-11, 3.239E-11, 2.585E-11, 2.584E-11, 2.492E-11, 2.796E-11, 2.524E-11, 2.278E-11, 2.833E-11, 2.215E-11, 1.667E-11, 1.707E-11, 2.104E-11, 2.550E-11, 2.791E-11, 2.359E-11, 1.442E-11, 1.165E-11, 1.434E-11, 1.630E-11, 1.561E-11, 1.709E-11, 1.607E-11, 1.448E-11, 1.288E-11
1.036E-11, 1.164E-11, 1.594E-11, 1.602E-11, 1.456E-11, 1.454E-11, 1.422E-11, 1.474E-11, 1.459E-11, 1.459E-11, 1.538E-11, 1.394E-11, 1.349E-11, 1.349E-11, 1.499E-11, 1.623E-11, 1.745E-11, 1.780E-11, 2.089E-11, 1.962E-11, 2.038E-11, 2.091E-11, 2.270E-11, 2.115E-11, 2.118E-11, 2.056E-11, 2.147E-11, 2.032E-11, 1.984E-11, 2.219E-11, 2.090E-11, 2.099E-11, 2.052E-11, 2.246E-11, 3.146E-11, 5.225E-11, 5.073E-11, 4.833E-11, 4.945E-11, 4.505E-11, 4.977E-11, 4.932E-11, 5.309E-11, 5.297E-11, 5.181E-11, 4.788E-11, 5.111E-11, 5.078E-11, 4.615E-11, 3.315E-11, 3.146E-11, 2.884E-11, 3.094E-11, 3.094E-11, 3.352E-11, 3.566E-11, 3.290E-11, 3.166E-11, 2.914E-11, 2.782E-11, 2.938E-11, 2.791E-11, 3.163E-11, 2.430E-11, 2.070E-11, 2.211E-11, 2.411E-11, 2.232E-11, 2.053E-11, 1.751E-11, 1.818E-11, 1.577E-11
1.865E-11, 1.863E-11, 1.861E-11, 1.860E-11, 1.767E-11, 1.704E-11, 1.711E-11, 1.594E-11, 1.461E-11, 1.549E-11, 1.539E-11, 1.394E-11, 1.509E-11, 1.522E-11, 1.544E-11, 1.487E-11, 1.550E-11, 1.616E-11, 1.745E-11, 1.772E-11, 1.807E-11, 1.775E-11, 1.835E-11, 1.845E-11, 1.779E-11, 1.724E-11, 1.824E-11, 1.856E-11, 1.855E-11, 1.691E-11, 1.516E-11, 1.678E-11, 1.738E-11, 1.781E-11, 1.853E-11, 2.047E-11, 2.545E-11, 2.733E-11, 2.948E-11, 2.902E-11, 2.553E-11, 2.869E-11, 3.566E-11, 3.577E-11, 2.892E-11, 3.416E-11, 4.100E-11, 4.060E-11, 3.809E-11, 3.610E-11, 3.808E-11, 3.929E-11, 3.421E-11, 3.584E-11, 3.881E-11, 4.210E-11, 3.741E-11, 3.689E-11, 3.681E-11, 3.462E-11, 3.468E-11, 2.955E-11, 3.818E-11, 3.059E-11, 2.807E-11, 2.886E-11, 2.568E-11, 2.473E-11, 2.111E-11, 1.885E-11, 1.937E-11, 1.865E-11
1.535E-11, 1.532E-11, 1.698E-11, 1.727E-11, 1.765E-11, 1.710E-11, 1.730E-11, 1.713E-11, 1.671E-11, 1.572E-11, 1.592E-11, 1.663E-11, 1.760E-11, 1.772E-11, 1.840E-11, 1.936E-11, 1.865E-11, 1.622E-11, 1.623E-11, 1.619E-11, 1.661E-11, 1.663E-11, 1.519E-11, 1.766E-11, 1.853E-11, 1.887E-11, 1.907E-11, 1.948E-11, 1.740E-11, 1.683E-11, 1.791E-11, 1.511E-11, 1.511E-11, 1.475E-11, 1.535E-11, 1.611E-11, 1.808E-11, 1.895E-11, 1.822E-11, 1.633E-11, 1.463E-11, 1.662E-11, 1.669E-11, 1.698E-11, 1.842E-11, 1.572E-11, 1.901E-11, 2.289E-11, 2.687E-11, 2.856E-11, 2.929E-11, 2.767E-11, 2.580E-11, 2.265E-11, 2.284E-11, 2.095E-11, 2.043E-11, 2.042E-11, 2.254E-11, 2.208E-11, 2.034E-11, 2.559E-11, 2.495E-11, 2.563E-11, 2.714E-11, 2.559E-11, 2.267E-11, 2.238E-11, 2.168E-11, 2.182E-11, 2.315E-11, 2.119E-11
1.532E-11, 1.532E-11, 1.594E-11, 1.594E-11, 1.618E-11, 1.636E-11, 1.670E-11, 1.748E-11, 1.888E-11, 1.768E-11, 1.719E-11, 1.835E-11, 1.823E-11, 1.693E-11, 1.681E-11, 1.790E-11, 1.918E-11, 1.975E-11, 2.002E-11, 1.970E-11, 2.017E-11, 2.035E-11, 2.089E-11, 2.165E-11, 2.147E-11, 2.146E-11, 2.159E-11, 1.909E-11, 1.853E-11, 1.857E-11, 2.183E-11, 1.839E-11, 1.737E-11, 1.588E-11, 1.643E-11, 1.675E-11, 1.690E-11, 1.655E-11, 1.784E-11, 1.810E-11, 1.758E-11, 1.759E-11, 1.685E-11, 1.691E-11, 1.740E-11, 1.736E-11, 1.680E-11, 1.545E-11, 1.693E-11, 1.718E-11, 1.548E-11, 1.698E-11, 1.649E-11, 1.615E-11, 1.480E-11, 1.454E-11, 1.456E-11, 1.581E-11, 1.617E-11, 1.630E-11, 1.666E-11, 1.820E-11, 1.852E-11, 1.845E-11, 1.753E-11, 1.969E-11, 2.008E-11, 1.991E-11, 1.819E-11, 1.737E-11, 1.722E-11, 1.641E-11
1.517E-11, 1.596E-11, 1.592E-11, 1.646E-11, 1.660E-11, 1.672E-11, 1.681E-11, 1.614E-11, 1.550E-11, 1.540E-11, 1.697E-11, 1.631E-11, 1.670E-11, 1.698E-11, 1.763E-11, 1.914E-11, 2.021E-11, 2.155E-11, 2.141E-11, 2.183E-11, 2.204E-11, 2.199E-11, 2.213E-11, 2.229E-11, 2.339E-11, 2.279E-11, 2.235E-11, 2.199E-11, 2.106E-11, 2.103E-11, 2.562E-11, 2.210E-11, 2.052E-11, 1.960E-11, 1.885E-11, 1.779E-11, 1.889E-11, 1.873E-11, 2.305E-11, 2.023E-11, 1.851E-11, 1.948E-11, 1.825E-11, 2.055E-11, 2.053E-11, 2.279E-11, 2.226E-11, 1.613E-11, 1.579E-11, 1.626E-11, 1.702E-11, 1.709E-11, 1.695E-11, 1.572E-11, 1.588E-11, 1.606E-11, 1.627E-11, 1.659E-11, 1.649E-11, 1.649E-11, 1.652E-11, 1.655E-11, 1.680E-11, 1.659E-11, 1.639E-11, 1.587E-11, 1.636E-11, 1.694E-11, 1.674E-11, 1.609E-11, 1.531E-11, 1.498E-11
1.688E-11, 1.644E-11, 1.672E-11, 1.692E-11, 1.739E-11, 1.720E-11, 1.694E-11, 1.694E-11, 1.645E-11, 1.650E-11, 1.733E-11, 1.843E-11, 1.778E-11, 1.833E-11, 1.827E-11, 1.860E-11, 1.866E-11, 1.883E-11, 1.982E-11, 2.209E-11, 2.223E-11, 2.268E-11, 2.331E-11, 2.298E-11, 2.284E-11, 2.261E-11, 2.141E-11, 2.039E-11, 2.082E-11, 2.098E-11, 2.024E-11, 2.238E-11, 2.455E-11, 2.128E-11, 1.926E-11, 2.484E-11, 3.105E-11, 2.537E-11, 1.959E-11, 1.910E-11, 1.790E-11, 1.678E-11, 1.699E-11, 1.702E-11, 1.565E-11, 1.547E-11, 1.710E-11, 2.109E-11, 2.230E-11, 2.334E-11, 2.243E-11, 1.886E-11, 1.831E-11, 1.745E-11, 1.675E-11, 1.685E-11, 1.676E-11, 1.649E-11, 1.728E-11, 1.726E-11, 1.723E-11, 1.679E-11, 1.717E-11, 1.773E-11, 1.697E-11, 1.653E-11, 1.659E-11, 1.629E-11, 1.628E-11, 1.636E-11, 1.639E-11, 1.682E-11
1.774E-11, 1.774E-11, 1.643E-11, 1.619E-11, 1.755E-11, 1.886E-11, 1.833E-11, 1.777E-11, 1.689E-11, 1.712E-11, 1.696E-11, 1.737E-11, 1.764E-11, 1.867E-11, 2.024E-11, 1.965E-11, 1.903E-11, 1.914E-11, 1.980E-11, 1.979E-11, 2.001E-11, 2.015E-11, 2.012E-11, 2.000E-11, 1.975E-11, 1.966E-11, 1.990E-11, 2.011E-11, 2.054E-11, 2.042E-11, 2.031E-11, 1.991E-11, 2.197E-11, 2.610E-11, 3.277E-11, 4.616E-11, 2.268E-11, 1.939E-11, 1.812E-11, 1.709E-11, 1.595E-11, 1.684E-11, 1.767E-11, 1.720E-11, 1.620E-11, 1.538E-11, 1.540E-11, 1.523E-11, 1.526E-11, 1.564E-11, 1.578E-11, 1.629E-11, 1.643E-11, 1.650E-11, 1.682E-11, 1.693E-11, 1.688E-11, 1.685E-11, 1.723E-11, 1.731E-11, 1.749E-11, 1.778E-11, 1.787E-11, 1.760E-11, 1.714E-11, 1.713E-11, 1.715E-11, 1.640E-11, 1.702E-11, 1.766E-11, 1.766E-11, 1.773E-11
1.667E-11, 1.629E-11, 1.592E-11, 1.685E-11, 1.920E-11, 1.949E-11, 1.913E-11, 2.006E-11, 2.026E-11, 2.001E-11, 1.831E-11, 1.782E-11, 1.782E-11, 1.822E-11, 1.826E-11, 1.875E-11, 1.920E-11, 1.918E-11, 1.953E-11, 2.022E-11, 2.023E-11, 1.993E-11, 1.928E-11, 1.908E-11, 1.886E-11, 1.926E-11, 1.969E-11, 1.976E-11, 1.932E-11, 1.904E-11, 1.928E-11, 1.904E-11, 1.857E-11, 1.866E-11, 1.933E-11, 1.915E-11, 1.922E-11, 1.866E-11, 1.820E-11, 1.822E-11, 1.802E-11, 1.778E-11, 1.709E-11, 1.681E-11, 1.694E-11, 1.711E-11, 1.678E-11, 1.645E-11, 1.694E-11, 1.681E-11, 1.666E-11, 1.613E-11, 1.599E-11, 1.643E-11, 1.686E-11, 1.686E-11, 1.660E-11, 1.704E-11, 1.710E-11, 1.744E-11, 1.772E-11, 1.786E-11, 1.775E-11, 1.772E-11, 1.726E-11, 1.726E-11, 1.806E-11, 1.808E-11, 1.805E-11, 1.694E-11, 1.692E-11, 1.681E-11
1.849E-11, 1.849E-11, 1.813E-11, 1.944E-11, 1.942E-11, 1.776E-11, 1.774E-11, 1.779E-11, 1.804E-11, 1.832E-11, 1.848E-11, 1.769E-11, 1.803E-11, 1.844E-11, 1.889E-11, 1.896E-11, 1.854E-11, 1.808E-11, 1.831E-11, 1.852E-11, 1.850E-11, 1.883E-11, 1.884E-11, 1.901E-11, 1.851E-11, 1.845E-11, 1.821E-11, 1.812E-11, 1.842E-11, 1.889E-11, 1.935E-11, 1.908E-11, 1.853E-11, 1.853E-11, 1.856E-11, 1.865E-11, 1.852E-11, 1.829E-11, 1.833E-11, 1.824E-11, 1.791E-11, 1.737E-11, 1.762E-11, 1.743E-11, 1.722E-11, 1.698E-11, 1.686E-11, 1.659E-11, 1.643E-11, 1.626E-11, 1.634E-11, 1.641E-11, 1.661E-11, 1.691E-11, 1.719E-11, 1.719E-11, 1.599E-11, 1.598E-11, 1.655E-11, 1.708E-11, 1.697E-11, 1.691E-11, 1.687E-11, 1.715E-11, 1.720E-11, 1.726E-11, 1.761E-11, 1.799E-11, 1.809E-11, 1.841E-11, 1.873E-11, 1.859E-11
1.680E-11, 1.777E-11, 1.834E-11, 1.834E-11, 1.807E-11, 1.780E-11, 1.752E-11, 1.736E-11, 1.793E-11, 1.865E-11, 1.863E-11, 1.892E-11, 1.884E-11, 1.851E-11, 1.797E-11, 1.743E-11, 1.792E-11, 1.842E-11, 1.856E-11, 1.856E-11, 1.894E-11, 1.954E-11, 1.947E-11, 1.917E-11, 1.896E-11, 1.901E-11, 1.850E-11, 1.848E-11, 1.897E-11, 1.895E-11, 1.894E-11, 1.896E-11, 1.894E-11, 1.855E-11, 1.836E-11, 1.815E-11, 1.825E-11, 1.836E-11, 1.841E-11, 1.831E-11, 1.811E-11, 1.800E-11, 1.804E-11, 1.810E-11, 1.825E-11, 1.861E-11, 1.843E-11, 1.820E-11, 1.807E-11, 1.848E-11, 1.866E-11, 1.829E-11, 1.781E-11, 1.776E-11, 1.727E-11, 1.709E-11, 1.696E-11, 1.701E-11, 1.770E-11, 1.809E-11, 1.849E-11, 1.881E-11, 1.882E-11, 1.885E-11, 1.815E-11, 1.750E-11, 1.761E-11, 1.772E-11, 1.771E-11, 1.727E-11, 1.680E-11, 1.679E-11
1.722E-11, 1.790E-11, 1.850E-11, 1.847E-11, 1.837E-11, 1.812E-11, 1.806E-11, 1.697E-11, 1.698E-11, 1.726E-11, 1.758E-11, 1.741E-11, 1.735E-11, 1.756E-11, 1.814E-11, 1.882E-11, 1.910E-11, 1.907E-11, 1.904E-11, 1.898E-11, 1.984E-11, 1.985E-11, 1.984E-11, 1.967E-11, 1.952E-11, 1.954E-11, 1.970E-11, 1.964E-11, 1.909E-11, 1.904E-11, 1.886E-11, 1.870E-11, 1.899E-11, 1.923E-11, 1.918E-11, 1.898E-11, 1.871E-11, 1.860E-11, 1.888E-11, 1.926E-11, 1.913E-11, 1.883E-11, 1.851E-11, 1.836E-11, 1.837E-11, 1.841E-11, 1.839E-11, 1.831E-11, 1.812E-11, 1.809E-11, 1.810E-11, 1.806E-11, 1.806E-11, 1.806E-11, 1.787E-11, 1.774E-11, 1.773E-11, 1.768E-11, 1.763E-11, 1.763E-11, 1.743E-11, 1.723E-11, 1.748E-11, 1.771E-11, 1.790E-11, 1.808E-11, 1.807E-11, 1.788E-11, 1.733E-11, 1.684E-11, 1.688E-11, 1.716E-11
1.656E-11, 1.774E-11, 1.797E-11, 1.792E-11, 1.768E-11, 1.751E-11, 1.757E-11, 1.771E-11, 1.794E-11, 1.797E-11, 1.812E-11, 1.828E-11, 1.838E-11, 1.863E-11, 1.885E-11, 1.884E-11, 1.887E-11, 1.889E-11, 1.889E-11, 1.889E-11, 1.885E-11, 1.877E-11, 1.865E-11, 1.854E-11, 1.832E-11, 1.796E-11, 1.803E-11, 1.824E-11, 1.836E-11, 1.917E-11, 1.943E-11, 1.962E-11, 1.963E-11, 1.961E-11, 1.958E-11, 1.958E-11, 1.955E-11, 1.939E-11, 1.930E-11, 1.916E-11, 1.912E-11, 1.910E-11, 1.903E-11, 1.892E-11, 1.881E-11, 1.879E-11, 1.875E-11, 1.869E-11, 1.873E-11, 1.885E-11, 1.876E-11, 1.839E-11, 1.831E-11, 1.831E-11, 1.836E-11, 1.841E-11, 1.835E-11, 1.803E-11, 1.790E-11, 1.816E-11, 1.849E-11, 1.858E-11, 1.855E-11, 1.854E-11, 1.835E-11, 1.748E-11, 1.727E-11, 1.708E-11, 1.683E-11, 1.656E-11, 1.643E-11, 1.627E-11
1.795E-11, 1.797E-11, 1.796E-11, 1.802E-11, 1.851E-11, 1.862E-11, 1.864E-11, 1.865E-11, 1.865E-11, 1.854E-11, 1.835E-11, 1.823E-11, 1.824E-11, 1.824E-11, 1.826E-11, 1.839E-11, 1.864E-11, 1.864E-11, 1.861E-11, 1.860E-11, 1.861E-11, 1.861E-11, 1.864E-11, 1.868E-11, 1.869E-11, 1.865E-11, 1.861E-11, 1.859E-11, 1.859E-11, 1.855E-11, 1.845E-11, 1.840E-11, 1.834E-11, 1.825E-11, 1.820E-11, 1.818E-11, 1.818E-11, 1.822E-11, 1.827E-11, 1.823E-11, 1.817E-11, 1.814E-11, 1.821E-11, 1.849E-11, 1.878E-11, 1.888E-11, 1.898E-11, 1.892E-11, 1.881E-11, 1.866E-11, 1.825E-11, 1.803E-11, 1.791E-11, 1.794E-11, 1.786E-11, 1.758E-11, 1.751E-11, 1.753E-11, 1.762E-11, 1.788E-11, 1.802E-11, 1.793E-11, 1.769E-11, 1.738E-11, 1.705E-11, 1.715E-11, 1.732E-11, 1.758E-11, 1.774E-11, 1.802E-11, 1.809E-11, 1.800E-11
1.769E-11, 1.792E-11, 1.817E-11, 1.823E-11, 1.825E-11, 1.825E-11, 1.825E-11, 1.825E-11, 1.825E-11, 1.825E-11, 1.827E-11, 1.829E-11, 1.829E-11, 1.830E-11, 1.830E-11, 1.828E-11, 1.826E-11, 1.823E-11, 1.821E-11, 1.821E-11, 1.823E-11, 1.830E-11, 1.831E-11, 1.827E-11, 1.823E-11, 1.814E-11, 1.806E-11, 1.802E-11, 1.801E-11, 1.798E-11, 1.799E-11, 1.799E-11, 1.797E-11, 1.793E-11, 1.788E-11, 1.786E-11, 1.789E-11, 1.788E-11, 1.783E-11, 1.784E-11, 1.783E-11, 1.779E-11, 1.775E-11, 1.772E-11, 1.773E-11, 1.778E-11, 1.788E-11, 1.807E-11, 1.825E-11, 1.834E-11, 1.836E-11, 1.829E-11, 1.817E-11, 1.793E-11, 1.770E-11, 1.757E-11, 1.753E-11, 1.751E-11, 1.747E-11, 1.741E-11, 1.734E-11, 1.731E-11, 1.732E-11, 1.740E-11, 1.745E-11, 1.750E-11, 1.755E-11, 1.761E-11, 1.763E-11, 1.761E-11, 1.762E-11, 1.763E-11
1.764E-11, 1.762E-11, 1.760E-11, 1.758E-11, 1.756E-11, 1.754E-11, 1.752E-11, 1.747E-11, 1.746E-11, 1.745E-11, 1.744E-11, 1.744E-11, 1.743E-11, 1.743E-11, 1.746E-11, 1.749E-11, 1.749E-11, 1.753E-11, 1.755E-11, 1.756E-11, 1.758E-11, 1.759E-11, 1.761E-11, 1.762E-11, 1.763E-11, 1.763E-11, 1.765E-11, 1.766E-11, 1.766E-11, 1.767E-11, 1.768E-11, 1.769E-11, 1.770E-11, 1.768E-11, 1.769E-11, 1.769E-11, 1.777E-11, 1.777E-11, 1.777E-11, 1.771E-11, 1.771E-11, 1.770E-11, 1.768E-11, 1.767E-11, 1.766E-11, 1.765E-11, 1.764E-11, 1.763E-11, 1.769E-11, 1.769E-11, 1.770E-11, 1.771E-11, 1.772E-11, 1.773E-11, 1.774E-11, 1.776E-11, 1.777E-11, 1.778E-11, 1.779E-11, 1.779E-11, 1.779E-11, 1.779E-11, 1.779E-11, 1.779E-11, 1.777E-11, 1.773E-11, 1.773E-11, 1.772E-11, 1.770E-11, 1.769E-11, 1.768E-11, 1.766E-11