6.635E-12, 6.657E-12, 6.678E-12, 6.698E-12, 6.717E-12, 6.734E-12, 6.752E-12, 6.771E-12, 6.792E-12, 6.814E-12, 6.947E-12, 6.967E-12, 6.990E-12, 7.013E-12, 7.036E-12, 7.057E-12, 7.077E-12, 7.096E-12, 7.111E-12, 7.083E-12, 7.094E-12, 7.102E-12, 7.106E-12, 7.105E-12, 7.098E-12, 7.084E-12, 7.062E-12, 6.929E-12, 6.888E-12, 6.840E-12, 6.786E-12, 6.729E-12, 6.671E-12, 6.616E-12, 6.568E-12, 6.527E-12, 6.597E-12, 6.562E-12, 6.533E-12, 6.506E-12, 6.482E-12, 6.415E-12, 6.354E-12, 6.335E-12, 6.297E-12, 6.277E-12, 6.257E-12, 6.238E-12, 6.220E-12, 6.204E-12, 6.340E-12, 6.341E-12, 6.346E-12, 6.354E-12, 6.368E-12, 6.386E-12, 6.408E-12, 6.432E-12, 6.455E-12, 6.478E-12, 6.499E-12, 6.516E-12, 6.532E-12, 6.500E-12, 6.512E-12, 6.523E-12, 6.534E-12, 6.546E-12, 6.560E-12, 6.575E-12, 6.593E-12, 6.614E-12
9.122E-12, 9.175E-12, 9.128E-12, 9.051E-12, 8.820E-12, 8.704E-12, 8.623E-12, 8.713E-12, 8.622E-12, 8.407E-12, 8.115E-12, 7.961E-12, 7.911E-12, 7.885E-12, 7.846E-12, 7.789E-12, 7.760E-12, 7.779E-12, 7.689E-12, 7.397E-12, 6.877E-12, 6.513E-12, 6.377E-12, 6.314E-12, 6.227E-12, 6.154E-12, 6.081E-12, 6.026E-12, 6.035E-12, 5.983E-12, 5.910E-12, 5.852E-12, 5.818E-12, 5.789E-12, 5.737E-12, 5.633E-12, 5.591E-12, 5.464E-12, 5.334E-12, 5.207E-12, 5.081E-12, 5.021E-12, 4.912E-12, 4.834E-12, 4.933E-12, 4.971E-12, 5.042E-12, 5.102E-12, 5.132E-12, 5.132E-12, 5.137E-12, 5.143E-12, 5.153E-12, 5.163E-12, 5.160E-12, 5.156E-12, 5.156E-12, 5.159E-12, 5.165E-12, 5.189E-12, 5.232E-12, 5.369E-12, 5.867E-12, 6.572E-12, 7.368E-12, 7.885E-12, 8.127E-12, 8.346E-12, 8.249E-12, 8.299E-12, 8.443E-12, 8.810E-12
1.155E-11, 1.188E-11, 1.186E-11, 1.180E-11, 1.154E-11, 1.118E-11, 1.098E-11, 1.036E-11, 9.493E-12, 9.031E-12, 8.746E-12, 8.630E-12, 8.660E-12, 8.437E-12, 8.269E-12, 8.322E-12, 8.594E-12, 9.062E-12, 9.526E-12, 9.941E-12, 1.022E-11, 1.064E-11, 1.096E-11, 1.106E-11, 1.056E-11, 1.002E-11, 9.160E-12, 8.586E-12, 8.708E-12, 8.605E-12, 8.140E-12, 5.596E-12, 5.184E-12, 5.157E-12, 5.146E-12, 5.130E-12, 5.187E-12, 5.523E-12, 5.898E-12, 5.924E-12, 5.809E-12, 5.711E-12, 5.571E-12, 5.566E-12, 5.630E-12, 5.960E-12, 6.191E-12, 6.380E-12, 6.481E-12, 6.442E-12, 6.460E-12, 6.439E-12, 6.425E-12, 6.428E-12, 6.430E-12, 6.483E-12, 6.512E-12, 5.874E-12, 5.733E-12, 5.693E-12, 5.657E-12, 5.586E-12, 5.722E-12, 6.023E-12, 6.349E-12, 6.809E-12, 7.170E-12, 7.690E-12, 9.001E-12, 9.722E-12, 1.021E-11, 1.089E-11
1.444E-11, 1.490E-11, 1.503E-11, 1.527E-11, 1.538E-11, 1.542E-11, 1.540E-11, 1.532E-11, 1.473E-11, 1.462E-11, 1.434E-11, 1.360E-11, 1.231E-11, 1.082E-11, 1.004E-11, 9.505E-12, 9.685E-12, 9.977E-12, 1.006E-11, 1.014E-11, 9.854E-12, 9.589E-12, 9.601E-12, 9.554E-12, 8.664E-12, 8.540E-12, 8.506E-12, 8.375E-12, 8.233E-12, 8.094E-12, 7.884E-12, 7.638E-12, 7.314E-12, 7.000E-12, 6.734E-12, 6.734E-12, 6.872E-12, 7.567E-12, 8.119E-12, 7.917E-12, 7.352E-12, 7.207E-12, 7.200E-12, 7.104E-12, 6.978E-12, 7.003E-12, 7.207E-12, 7.427E-12, 7.834E-12, 8.829E-12, 9.999E-12, 1.085E-11, 1.069E-11, 1.074E-11, 9.890E-12, 9.777E-12, 9.706E-12, 9.571E-12, 9.379E-12, 8.262E-12, 8.007E-12, 8.013E-12, 7.646E-12, 7.335E-12, 7.475E-12, 7.915E-12, 9.063E-12, 1.044E-11, 1.148E-11, 1.250E-11, 1.322E-11, 1.380E-11
1.685E-11, 1.646E-11, 1.648E-11, 1.614E-11, 1.588E-11, 1.571E-11, 1.525E-11, 1.502E-11, 1.499E-11, 1.438E-11, 1.432E-11, 1.395E-11, 1.343E-11, 1.283E-11, 1.236E-11, 1.237E-11, 1.190E-11, 1.176E-11, 1.174E-11, 1.111E-11, 1.051E-11, 1.039E-11, 8.751E-12, 8.769E-12, 9.333E-12, 1.031E-11, 1.058E-11, 9.992E-12, 9.143E-12, 8.369E-12, 7.924E-12, 7.910E-12, 8.152E-12, 8.891E-12, 9.256E-12, 9.658E-12, 1.012E-11, 1.014E-11, 1.022E-11, 9.879E-12, 9.845E-12, 9.867E-12, 1.004E-11, 1.020E-11, 1.048E-11, 1.017E-11, 9.732E-12, 1.009E-11, 1.072E-11, 1.132E-11, 1.189E-11, 1.246E-11, 1.271E-11, 1.268E-11, 1.256E-11, 1.241E-11, 1.237E-11, 1.248E-11, 1.383E-11, 1.375E-11, 1.339E-11, 1.329E-11, 1.315E-11, 1.303E-11, 1.384E-11, 1.475E-11, 1.545E-11, 1.654E-11, 1.679E-11, 1.714E-11, 1.768E-11, 1.777E-11
1.638E-11, 1.638E-11, 1.605E-11, 1.605E-11, 1.604E-11, 1.548E-11, 1.544E-11, 1.528E-11, 1.468E-11, 1.407E-11, 1.408E-11, 1.420E-11, 1.392E-11, 1.278E-11, 1.203E-11, 1.205E-11, 1.211E-11, 1.212E-11, 1.190E-11, 1.119E-11, 1.118E-11, 9.854E-12, 9.932E-12, 1.035E-11, 1.043E-11, 9.784E-12, 9.114E-12, 9.018E-12, 9.255E-12, 9.117E-12, 8.553E-12, 8.085E-12, 8.096E-12, 8.075E-12, 8.196E-12, 8.711E-12, 9.172E-12, 1.018E-11, 1.123E-11, 1.179E-11, 1.224E-11, 1.286E-11, 1.366E-11, 1.421E-11, 1.472E-11, 1.445E-11, 1.323E-11, 1.331E-11, 1.346E-11, 1.379E-11, 1.427E-11, 1.427E-11, 1.608E-11, 1.630E-11, 1.690E-11, 1.733E-11, 1.706E-11, 1.724E-11, 1.821E-11, 1.826E-11, 1.795E-11, 1.764E-11, 1.683E-11, 1.580E-11, 1.563E-11, 1.567E-11, 1.649E-11, 1.692E-11, 1.655E-11, 1.716E-11, 1.780E-11, 1.763E-11
1.431E-11, 1.448E-11, 1.428E-11, 1.490E-11, 1.573E-11, 1.656E-11, 1.629E-11, 1.489E-11, 1.427E-11, 1.364E-11, 1.347E-11, 1.299E-11, 1.212E-11, 1.263E-11, 1.298E-11, 1.268E-11, 1.267E-11, 1.198E-11, 1.193E-11, 1.187E-11, 1.147E-11, 1.093E-11, 1.087E-11, 1.108E-11, 1.105E-11, 1.108E-11, 1.059E-11, 1.066E-11, 1.006E-11, 9.499E-12, 9.658E-12, 9.206E-12, 8.364E-12, 8.384E-12, 9.104E-12, 9.647E-12, 1.009E-11, 1.025E-11, 1.047E-11, 1.046E-11, 1.055E-11, 1.096E-11, 1.234E-11, 1.334E-11, 1.350E-11, 1.404E-11, 1.491E-11, 1.493E-11, 1.412E-11, 1.344E-11, 1.333E-11, 1.435E-11, 1.561E-11, 1.686E-11, 1.738E-11, 1.770E-11, 1.776E-11, 1.787E-11, 1.857E-11, 1.767E-11, 1.715E-11, 1.639E-11, 1.538E-11, 1.456E-11, 1.394E-11, 1.385E-11, 1.388E-11, 1.371E-11, 1.374E-11, 1.458E-11, 1.453E-11, 1.414E-11
1.407E-11, 1.480E-11, 1.555E-11, 1.580E-11, 1.497E-11, 1.469E-11, 1.325E-11, 1.231E-11, 1.273E-11, 1.289E-11, 1.206E-11, 1.179E-11, 1.189E-11, 1.201E-11, 1.230E-11, 1.252E-11, 1.177E-11, 1.170E-11, 1.215E-11, 1.178E-11, 1.115E-11, 1.044E-11, 1.056E-11, 1.120E-11, 1.280E-11, 1.262E-11, 1.303E-11, 1.221E-11, 1.218E-11, 1.023E-11, 9.241E-12, 9.121E-12, 8.425E-12, 8.568E-12, 8.374E-12, 8.858E-12, 8.632E-12, 8.853E-12, 9.299E-12, 9.203E-12, 9.744E-12, 1.026E-11, 1.165E-11, 1.270E-11, 1.296E-11, 1.307E-11, 1.351E-11, 1.318E-11, 1.289E-11, 1.218E-11, 1.236E-11, 1.255E-11, 1.330E-11, 1.303E-11, 1.295E-11, 1.358E-11, 1.431E-11, 1.596E-11, 1.615E-11, 1.551E-11, 1.542E-11, 1.379E-11, 1.308E-11, 1.176E-11, 1.169E-11, 1.189E-11, 1.231E-11, 1.217E-11, 1.260E-11, 1.260E-11, 1.229E-11, 1.271E-11
1.372E-11, 1.468E-11, 1.565E-11, 1.417E-11, 1.404E-11, 1.393E-11, 1.324E-11, 1.328E-11, 1.415E-11, 1.278E-11, 1.142E-11, 1.130E-11, 1.099E-11, 1.118E-11, 1.124E-11, 1.055E-11, 1.121E-11, 1.137E-11, 1.073E-11, 1.081E-11, 1.146E-11, 9.894E-12, 1.009E-11, 1.188E-11, 1.350E-11, 1.339E-11, 1.254E-11, 1.134E-11, 1.129E-11, 1.088E-11, 1.086E-11, 1.065E-11, 1.046E-11, 1.111E-11, 1.029E-11, 9.586E-12, 9.705E-12, 9.243E-12, 9.435E-12, 9.568E-12, 9.806E-12, 9.812E-12, 1.030E-11, 9.988E-12, 1.110E-11, 1.202E-11, 1.243E-11, 1.233E-11, 1.211E-11, 1.075E-11, 1.066E-11, 1.115E-11, 1.150E-11, 1.126E-11, 1.195E-11, 1.314E-11, 1.241E-11, 1.161E-11, 1.192E-11, 1.194E-11, 1.094E-11, 9.873E-12, 9.400E-12, 8.946E-12, 9.620E-12, 1.085E-11, 1.036E-11, 1.126E-11, 1.164E-11, 1.206E-11, 1.273E-11, 1.289E-11
1.115E-11, 1.377E-11, 1.411E-11, 1.390E-11, 1.411E-11, 1.340E-11, 1.218E-11, 1.202E-11, 1.164E-11, 1.260E-11, 1.187E-11, 1.112E-11, 1.118E-11, 9.464E-12, 9.317E-12, 8.219E-12, 9.064E-12, 8.565E-12, 9.751E-12, 9.860E-12, 1.004E-11, 1.001E-11, 1.237E-11, 1.780E-11, 1.532E-11, 1.431E-11, 1.462E-11, 1.155E-11, 1.099E-11, 1.051E-11, 1.035E-11, 1.023E-11, 9.730E-12, 1.061E-11, 1.183E-11, 1.136E-11, 1.127E-11, 1.229E-11, 1.168E-11, 1.035E-11, 1.031E-11, 1.025E-11, 1.051E-11, 1.090E-11, 1.076E-11, 1.187E-11, 1.027E-11, 1.041E-11, 1.049E-11, 1.096E-11, 1.053E-11, 9.337E-12, 1.005E-11, 1.054E-11, 1.102E-11, 1.089E-11, 1.348E-11, 1.295E-11, 1.253E-11, 1.123E-11, 1.137E-11, 1.366E-11, 1.360E-11, 1.376E-11, 1.397E-11, 1.242E-11, 1.206E-11, 1.184E-11, 1.280E-11, 1.191E-11, 1.121E-11, 9.135E-12
1.322E-11, 1.617E-11, 1.738E-11, 1.577E-11, 1.519E-11, 1.450E-11, 1.312E-11, 1.328E-11, 1.124E-11, 1.250E-11, 1.275E-11, 1.106E-11, 1.081E-11, 1.099E-11, 9.689E-12, 8.014E-12, 8.828E-12, 7.873E-12, 7.926E-12, 9.401E-12, 1.090E-11, 1.407E-11, 2.432E-11, 2.954E-11, 2.002E-11, 1.405E-11, 1.375E-11, 1.180E-11, 9.021E-12, 7.658E-12, 7.649E-12, 7.477E-12, 7.709E-12, 8.803E-12, 9.224E-12, 9.617E-12, 8.552E-12, 7.705E-12, 9.301E-12, 9.217E-12, 1.123E-11, 1.575E-11, 1.996E-11, 2.407E-11, 2.021E-11, 1.334E-11, 1.801E-11, 1.140E-11, 8.819E-12, 7.365E-12, 8.550E-12, 1.046E-11, 9.842E-12, 9.826E-12, 8.684E-12, 8.373E-12, 9.801E-12, 1.223E-11, 1.193E-11, 1.702E-11, 2.060E-11, 1.536E-11, 1.460E-11, 1.728E-11, 1.602E-11, 1.825E-11, 1.971E-11, 2.077E-11, 1.576E-11, 7.143E-12, 7.805E-12, 9.304E-12
1.710E-11, 1.841E-11, 1.511E-11, 1.463E-11, 1.449E-11, 1.469E-11, 1.382E-11, 1.199E-11, 1.290E-11, 1.325E-11, 1.054E-11, 1.013E-11, 1.139E-11, 1.066E-11, 9.934E-12, 9.214E-12, 8.240E-12, 9.886E-12, 8.910E-12, 9.307E-12, 8.640E-12, 7.902E-12, 1.848E-11, 2.794E-11, 1.798E-11, 1.347E-11, 9.242E-12, 7.450E-12, 8.367E-12, 8.020E-12, 6.664E-12, 5.938E-12, 6.301E-12, 6.519E-12, 6.588E-12, 7.755E-12, 8.235E-12, 9.046E-12, 8.414E-12, 1.005E-11, 2.639E-11, 4.120E-11, 4.724E-11, 4.341E-11, 1.834E-11, 1.111E-11, 1.050E-11, 1.182E-11, 6.617E-12, 7.808E-12, 8.804E-12, 9.374E-12, 1.181E-11, 8.884E-12, 9.739E-12, 1.355E-11, 1.495E-11, 1.247E-11, 1.819E-11, 3.710E-11, 2.480E-11, 2.266E-11, 1.813E-11, 2.200E-11, 2.679E-11, 2.497E-11, 2.282E-11, 1.699E-11, 1.340E-11, 7.399E-12, 1.009E-11, 1.179E-11
1.207E-11, 1.709E-11, 1.484E-11, 1.332E-11, 1.208E-11, 1.197E-11, 1.098E-11, 8.653E-12, 9.257E-12, 1.157E-11, 1.024E-11, 1.121E-11, 1.006E-11, 1.016E-11, 1.026E-11, 9.484E-12, 7.215E-12, 8.574E-12, 6.249E-12, 7.284E-12, 6.884E-12, 6.418E-12, 1.139E-11, 1.657E-11, 1.219E-11, 8.146E-12, 7.554E-12, 6.381E-12, 5.906E-12, 6.417E-12, 5.776E-12, 6.678E-12, 5.768E-12, 6.252E-12, 5.424E-12, 7.538E-12, 7.463E-12, 6.978E-12, 8.751E-12, 2.327E-11, 5.214E-11, 3.284E-10, 1.748E-10, 2.016E-11, 1.124E-11, 9.256E-12, 1.041E-11, 1.174E-11, 8.780E-12, 9.482E-12, 1.152E-11, 7.343E-12, 7.835E-12, 9.454E-12, 1.080E-11, 1.245E-11, 1.320E-11, 9.974E-12, 1.625E-11, 2.087E-11, 1.809E-11, 1.495E-11, 1.481E-11, 2.095E-11, 2.194E-11, 2.878E-11, 1.552E-11, 1.083E-11, 8.191E-12, 1.007E-11, 1.007E-11, 1.196E-11
8.757E-12, 1.081E-11, 9.084E-12, 9.864E-12, 9.350E-12, 9.896E-12, 8.623E-12, 7.024E-12, 5.935E-12, 8.427E-12, 1.166E-11, 1.160E-11, 9.048E-12, 8.587E-12, 7.834E-12, 6.449E-12, 6.472E-12, 5.021E-12, 3.257E-12, 2.452E-12, 3.210E-12, 6.079E-12, 1.046E-11, 1.352E-11, 7.072E-12, 9.218E-12, 7.516E-12, 9.567E-12, 7.678E-12, 7.158E-12, 6.960E-12, 4.249E-12, 2.807E-12, 3.920E-12, 4.427E-12, 5.987E-12, 4.835E-12, 3.466E-12, 6.522E-12, 1.112E-11, 2.327E-11, 7.882E-11, 6.025E-11, 1.770E-11, 5.389E-12, 9.711E-12, 9.584E-12, 1.337E-11, 1.127E-11, 1.079E-11, 1.055E-11, 1.102E-11, 1.607E-11, 1.203E-11, 1.077E-11, 6.931E-12, 6.435E-12, 8.863E-12, 2.070E-11, 2.515E-11, 1.366E-11, 1.591E-11, 2.812E-11, 1.926E-11, 1.958E-11, 7.292E-12, 1.327E-11, 7.767E-12, 8.156E-12, 8.111E-12, 8.858E-12, 7.825E-12
7.638E-12, 6.277E-12, 7.351E-12, 7.534E-12, 7.014E-12, 9.284E-12, 7.043E-12, 4.336E-12, 3.534E-12, 6.937E-12, 8.378E-12, 1.171E-11, 1.301E-11, 1.006E-11, 7.653E-12, 5.412E-12, 3.430E-12, 3.236E-12, 1.499E-12, 1.886E-12, 1.157E-12, 4.733E-12, 6.286E-12, 1.104E-11, 6.397E-12, 1.075E-11, 1.128E-11, 9.051E-12, 9.295E-12, 6.018E-12, 6.368E-12, 3.824E-12, 2.751E-12, 2.339E-12, 3.082E-12, 3.125E-12, 2.761E-12, 3.020E-12, 6.774E-12, 9.570E-12, 1.197E-11, 1.060E-11, 3.907E-12, 2.506E-12, 1.747E-12, 3.852E-12, 8.721E-12, 1.002E-11, 9.728E-12, 1.037E-11, 1.205E-11, 1.292E-11, 1.396E-11, 1.414E-11, 1.243E-11, 6.133E-12, 5.230E-12, 7.361E-12, 8.532E-12, 8.669E-12, 7.252E-12, 7.518E-12, 1.112E-11, 8.583E-12, 5.014E-12, 3.697E-12, 3.386E-12, 3.100E-12, 2.452E-12, 4.157E-12, 4.489E-12, 5.421E-12
4.582E-12, 5.245E-12, 5.831E-12, 5.165E-12, 5.846E-12, 7.055E-12, 6.907E-12, 5.948E-12, 5.477E-12, 6.919E-12, 1.106E-11, 1.253E-11, 1.443E-11, 1.051E-11, 4.112E-12, 3.213E-12, 2.226E-12, 3.119E-12, 1.419E-12, 2.196E-12, 1.159E-12, 2.834E-12, 1.606E-12, 1.662E-12, 2.591E-12, 7.975E-12, 5.004E-12, 6.437E-12, 1.018E-11, 1.043E-11, 1.028E-11, 5.665E-12, 4.200E-12, 3.537E-12, 2.968E-12, 2.021E-12, 1.575E-12, 8.828E-13, 8.140E-13, 6.187E-13, 7.117E-13, 7.350E-13, 1.602E-12, 1.852E-12, 1.945E-12, 3.432E-12, 3.813E-12, 5.189E-12, 7.054E-12, 8.955E-12, 9.586E-12, 1.233E-11, 1.410E-11, 1.319E-11, 1.112E-11, 6.936E-12, 7.766E-12, 6.762E-12, 6.503E-12, 4.195E-12, 4.453E-12, 3.958E-12, 3.813E-12, 3.569E-12, 2.291E-12, 2.660E-12, 2.123E-12, 1.719E-12, 1.566E-12, 2.583E-12, 3.802E-12, 4.815E-12
3.975E-12, 5.988E-12, 8.697E-12, 8.613E-12, 9.805E-12, 1.631E-11, 1.454E-11, 1.557E-11, 1.037E-11, 8.566E-12, 1.466E-11, 1.524E-11, 1.464E-11, 8.516E-12, 8.078E-12, 5.778E-12, 3.838E-12, 4.057E-12, 2.246E-12, 4.943E-12, 5.413E-12, 4.827E-12, 3.781E-12, 2.974E-12, 1.965E-12, 1.779E-12, 1.878E-12, 6.123E-12, 1.255E-11, 1.537E-11, 1.541E-11, 1.127E-11, 7.654E-12, 6.104E-12, 4.811E-12, 5.057E-12, 2.140E-12, 3.629E-12, 1.143E-12, 1.568E-12, 1.439E-12, 1.007E-12, 2.193E-12, 2.369E-12, 2.550E-12, 4.524E-12, 3.053E-12, 3.949E-12, 5.458E-12, 4.903E-12, 6.830E-12, 9.477E-12, 7.796E-12, 6.820E-12, 4.555E-12, 4.332E-12, 3.233E-12, 9.835E-12, 9.154E-12, 5.790E-12, 4.496E-12, 5.056E-12, 5.138E-12, 3.924E-12, 2.110E-12, 2.882E-12, 1.768E-12, 2.052E-12, 2.487E-12, 3.377E-12, 5.060E-12, 5.235E-12
1.068E-11, 1.327E-11, 1.548E-11, 1.628E-11, 1.768E-11, 1.403E-11, 1.821E-11, 1.589E-11, 8.276E-12, 6.320E-12, 6.048E-12, 6.900E-12, 5.087E-12, 2.757E-12, 2.281E-12, 1.768E-12, 1.127E-12, 2.261E-12, 4.012E-12, 3.241E-12, 6.598E-12, 4.608E-12, 4.765E-12, 4.535E-12, 2.705E-12, 1.193E-12, 1.531E-12, 3.389E-12, 9.632E-12, 1.053E-11, 1.140E-11, 8.114E-12, 7.509E-12, 6.310E-12, 7.723E-12, 5.009E-12, 6.578E-12, 1.508E-11, 1.498E-11, 2.627E-11, 2.867E-12, 3.047E-12, 6.436E-12, 3.164E-12, 3.663E-12, 4.854E-12, 4.127E-12, 2.755E-12, 2.962E-12, 2.495E-12, 2.777E-12, 5.666E-12, 3.961E-12, 3.037E-12, 1.986E-12, 2.178E-12, 2.801E-12, 6.162E-12, 6.402E-12, 6.196E-12, 4.979E-12, 4.957E-12, 5.535E-12, 4.954E-12, 5.885E-12, 5.209E-12, 5.261E-12, 6.629E-12, 6.218E-12, 8.564E-12, 9.969E-12, 1.082E-11
1.987E-11, 1.967E-11, 1.952E-11, 2.275E-11, 2.011E-11, 1.301E-11, 1.218E-11, 8.453E-12, 4.519E-12, 3.971E-12, 2.134E-12, 2.012E-12, 2.209E-12, 2.238E-12, 1.749E-12, 2.553E-12, 2.237E-12, 1.884E-12, 1.415E-12, 1.987E-12, 1.342E-12, 2.354E-12, 2.376E-12, 6.047E-12, 4.214E-12, 6.179E-12, 6.380E-12, 7.198E-12, 8.580E-12, 9.291E-12, 1.124E-11, 1.838E-11, 2.502E-11, 2.820E-11, 3.361E-11, 5.346E-11, 4.828E-11, 8.607E-11, 5.821E-11, 4.990E-11, 2.361E-11, 1.775E-11, 8.803E-12, 5.313E-12, 5.290E-12, 5.550E-12, 4.652E-12, 3.344E-12, 2.997E-12, 3.738E-12, 6.263E-12, 6.501E-12, 7.285E-12, 3.243E-12, 3.557E-12, 8.496E-12, 1.363E-11, 5.713E-12, 8.381E-12, 7.623E-12, 7.131E-12, 9.170E-12, 9.485E-12, 9.010E-12, 1.128E-11, 1.064E-11, 1.155E-11, 1.301E-11, 1.322E-11, 2.008E-11, 2.086E-11, 2.424E-11
2.487E-11, 2.399E-11, 2.244E-11, 1.912E-11, 1.636E-11, 1.235E-11, 1.251E-11, 8.052E-12, 8.146E-12, 6.295E-12, 5.155E-12, 5.629E-12, 5.094E-12, 5.186E-12, 8.098E-12, 6.721E-12, 5.685E-12, 5.551E-12, 7.169E-12, 6.298E-12, 4.209E-12, 3.346E-12, 5.131E-12, 8.752E-12, 1.123E-11, 1.295E-11, 1.359E-11, 1.642E-11, 1.731E-11, 2.562E-11, 3.709E-11, 5.130E-11, 4.143E-11, 3.557E-11, 3.346E-11, 3.533E-11, 4.882E-11, 7.930E-11, 5.335E-11, 8.543E-11, 3.750E-11, 1.520E-11, 2.208E-11, 1.462E-11, 4.157E-12, 5.923E-12, 5.592E-12, 5.746E-12, 6.729E-12, 8.653E-12, 8.227E-12, 1.458E-11, 1.061E-11, 9.638E-12, 1.175E-11, 1.062E-11, 8.199E-12, 1.016E-11, 1.210E-11, 1.549E-11, 1.736E-11, 1.285E-11, 1.171E-11, 1.177E-11, 1.333E-11, 1.241E-11, 1.405E-11, 1.522E-11, 1.550E-11, 1.465E-11, 1.628E-11, 1.959E-11
1.298E-11, 1.514E-11, 1.424E-11, 1.845E-11, 1.412E-11, 1.039E-11, 8.923E-12, 9.161E-12, 9.104E-12, 1.648E-11, 2.114E-11, 1.873E-11, 1.331E-11, 7.396E-12, 6.406E-12, 7.117E-12, 6.874E-12, 4.783E-12, 7.326E-12, 1.011E-11, 9.257E-12, 9.404E-12, 1.204E-11, 1.272E-11, 9.255E-12, 1.014E-11, 1.365E-11, 1.565E-11, 1.681E-11, 2.176E-11, 3.455E-11, 4.590E-11, 5.276E-11, 6.454E-11, 3.638E-11, 1.916E-11, 1.535E-11, 1.848E-11, 2.193E-11, 3.626E-11, 2.787E-11, 2.858E-11, 2.676E-11, 2.204E-11, 1.650E-11, 8.110E-12, 7.714E-12, 8.527E-12, 7.340E-12, 7.095E-12, 1.714E-11, 6.327E-11, 3.171E-11, 1.001E-11, 1.007E-11, 8.796E-12, 1.679E-11, 1.705E-11, 1.958E-11, 2.303E-11, 2.319E-11, 1.830E-11, 1.505E-11, 1.232E-11, 1.001E-11, 9.848E-12, 1.107E-11, 1.312E-11, 1.125E-11, 1.138E-11, 1.073E-11, 1.271E-11
9.204E-12, 1.039E-11, 1.021E-11, 1.441E-11, 1.232E-11, 1.150E-11, 1.289E-11, 8.235E-12, 1.932E-11, 3.030E-11, 2.219E-11, 2.465E-11, 1.715E-11, 9.666E-12, 1.182E-11, 1.401E-11, 1.525E-11, 6.909E-12, 9.382E-12, 1.461E-11, 2.666E-11, 2.039E-11, 2.155E-11, 1.328E-11, 1.152E-11, 1.151E-11, 1.174E-11, 1.064E-11, 1.208E-11, 1.785E-11, 2.766E-11, 2.953E-11, 2.806E-11, 3.084E-11, 3.020E-11, 2.890E-11, 2.272E-11, 2.582E-11, 2.071E-11, 1.737E-11, 2.653E-11, 2.050E-11, 2.508E-11, 3.053E-11, 1.867E-11, 1.539E-11, 1.612E-11, 1.786E-11, 1.041E-11, 1.243E-11, 2.055E-11, 6.862E-11, 6.615E-11, 5.289E-11, 4.316E-11, 2.770E-11, 3.837E-11, 1.928E-11, 1.304E-11, 2.310E-11, 1.756E-11, 1.250E-11, 9.989E-12, 1.119E-11, 1.069E-11, 8.608E-12, 1.128E-11, 1.683E-11, 1.431E-11, 1.986E-11, 1.620E-11, 2.250E-11
2.329E-11, 1.338E-11, 1.087E-11, 2.144E-11, 1.913E-11, 1.173E-11, 1.030E-11, 8.310E-12, 7.393E-12, 1.226E-11, 1.339E-11, 1.769E-11, 1.788E-11, 1.673E-11, 1.784E-11, 1.737E-11, 5.894E-11, 3.217E-11, 2.825E-11, 2.617E-11, 2.008E-11, 1.829E-11, 1.646E-11, 1.228E-11, 1.518E-11, 1.108E-11, 1.360E-11, 1.285E-11, 1.388E-11, 2.014E-11, 1.773E-11, 2.060E-11, 2.106E-11, 1.790E-11, 1.519E-11, 1.499E-11, 1.193E-11, 1.577E-11, 1.526E-11, 1.284E-11, 1.576E-11, 1.600E-11, 2.180E-11, 2.383E-11, 1.950E-11, 1.559E-11, 1.754E-11, 1.528E-11, 2.323E-11, 3.050E-11, 3.658E-11, 3.048E-11, 5.094E-11, 5.602E-11, 5.347E-11, 4.960E-11, 4.753E-11, 5.089E-11, 3.411E-11, 2.752E-11, 1.398E-11, 1.723E-11, 1.404E-11, 1.413E-11, 1.849E-11, 1.525E-11, 1.866E-11, 1.344E-11, 2.157E-11, 4.461E-11, 3.736E-11, 6.683E-11
4.882E-11, 2.974E-11, 2.701E-11, 3.358E-11, 3.859E-11, 2.962E-11, 3.124E-11, 1.739E-11, 9.871E-12, 1.029E-11, 1.179E-11, 1.111E-11, 1.646E-11, 1.816E-11, 2.127E-11, 2.513E-11, 9.038E-11, 5.273E-11, 4.605E-11, 3.416E-11, 2.426E-11, 2.180E-11, 1.908E-11, 1.777E-11, 4.428E-11, 2.911E-11, 1.974E-11, 1.346E-11, 1.387E-11, 1.443E-11, 1.023E-11, 1.528E-11, 1.459E-11, 1.687E-11, 1.455E-11, 1.291E-11, 1.248E-11, 1.185E-11, 1.456E-11, 2.006E-11, 2.195E-11, 2.141E-11, 2.555E-11, 2.792E-11, 2.033E-11, 1.915E-11, 1.967E-11, 1.755E-11, 2.775E-11, 3.960E-11, 6.442E-11, 8.385E-11, 7.377E-11, 6.953E-11, 6.891E-11, 7.234E-11, 7.721E-11, 1.327E-10, 1.429E-10, 1.481E-10, 1.065E-10, 1.100E-10, 8.072E-11, 7.151E-11, 5.750E-11, 4.014E-11, 3.936E-11, 3.524E-11, 4.249E-11, 4.757E-11, 5.430E-11, 4.018E-11
3.695E-11, 3.124E-11, 3.289E-11, 2.188E-11, 1.120E-11, 1.132E-11, 1.442E-11, 1.610E-11, 1.956E-11, 1.839E-11, 3.108E-11, 1.920E-11, 1.248E-11, 1.665E-11, 2.797E-11, 3.157E-11, 3.960E-11, 4.810E-11, 3.866E-11, 4.216E-11, 3.756E-11, 4.781E-11, 6.144E-11, 7.956E-11, 5.358E-11, 2.499E-11, 2.174E-11, 3.510E-11, 3.373E-11, 2.673E-11, 1.505E-11, 1.147E-11, 9.383E-12, 1.039E-11, 1.214E-11, 1.359E-11, 1.396E-11, 1.718E-11, 2.386E-11, 2.927E-11, 2.268E-11, 3.553E-11, 6.773E-11, 6.939E-11, 7.740E-11, 6.509E-11, 5.358E-11, 6.155E-11, 5.746E-11, 5.585E-11, 9.630E-11, 7.927E-11, 5.997E-11, 6.632E-11, 5.940E-11, 1.319E-10, 2.239E-10, 4.890E-10, 4.597E-10, 3.478E-10, 2.575E-10, 1.587E-10, 1.082E-10, 8.404E-11, 1.093E-10, 7.952E-11, 7.900E-11, 1.051E-10, 5.945E-11, 4.367E-11, 4.317E-11, 3.621E-11
1.465E-11, 1.082E-11, 9.329E-12, 9.564E-12, 8.209E-12, 8.883E-12, 1.033E-11, 8.729E-12, 7.067E-12, 6.495E-12, 7.593E-12, 1.986E-11, 1.260E-11, 2.243E-11, 4.245E-11, 6.168E-11, 6.433E-11, 7.040E-11, 9.128E-11, 5.149E-11, 4.938E-11, 4.346E-11, 3.488E-11, 3.293E-11, 2.634E-11, 1.412E-11, 1.648E-11, 1.947E-11, 2.823E-11, 1.952E-11, 1.370E-11, 1.310E-11, 1.152E-11, 1.177E-11, 1.669E-11, 2.067E-11, 2.209E-11, 2.594E-11, 3.829E-11, 5.170E-11, 2.875E-11, 5.083E-11, 6.987E-11, 6.326E-11, 6.633E-11, 7.975E-11, 8.366E-11, 8.401E-11, 9.185E-11, 8.717E-11, 7.205E-11, 8.860E-11, 1.153E-10, 1.470E-10, 1.294E-10, 9.053E-11, 9.181E-11, 1.212E-10, 1.231E-10, 3.019E-10, 4.594E-10, 3.651E-10, 2.207E-10, 1.638E-10, 1.476E-10, 9.915E-11, 7.081E-11, 5.291E-11, 4.224E-11, 3.104E-11, 2.095E-11, 1.897E-11
1.227E-11, 8.870E-12, 7.712E-12, 7.486E-12, 7.551E-12, 8.525E-12, 8.535E-12, 7.268E-12, 6.471E-12, 5.768E-12, 5.568E-12, 5.553E-12, 9.296E-12, 2.997E-11, 6.504E-11, 8.042E-11, 8.365E-11, 7.118E-11, 1.023E-10, 6.260E-11, 5.834E-11, 4.561E-11, 4.945E-11, 3.461E-11, 2.907E-11, 3.373E-11, 3.149E-11, 2.734E-11, 3.000E-11, 2.929E-11, 2.534E-11, 1.882E-11, 2.319E-11, 3.129E-11, 3.059E-11, 3.843E-11, 3.185E-11, 3.749E-11, 4.760E-11, 3.885E-11, 3.599E-11, 9.566E-11, 8.904E-11, 6.284E-11, 7.345E-11, 7.907E-11, 5.883E-11, 5.685E-11, 6.622E-11, 7.275E-11, 8.250E-11, 8.279E-11, 9.033E-11, 9.161E-11, 9.245E-11, 7.872E-11, 7.595E-11, 6.538E-11, 6.910E-11, 6.608E-11, 1.494E-10, 1.251E-10, 9.966E-11, 1.500E-10, 8.708E-11, 9.280E-11, 9.856E-11, 7.827E-11, 4.076E-11, 3.044E-11, 2.149E-11, 1.692E-11
1.274E-11, 1.127E-11, 8.290E-12, 8.655E-12, 8.078E-12, 7.143E-12, 6.733E-12, 5.249E-12, 5.991E-12, 6.359E-12, 5.362E-12, 6.662E-12, 8.500E-12, 1.670E-11, 2.549E-11, 4.523E-11, 5.081E-11, 6.993E-11, 5.363E-11, 8.015E-11, 5.243E-11, 3.898E-11, 3.319E-11, 2.990E-11, 3.460E-11, 4.321E-11, 3.882E-11, 2.853E-11, 2.726E-11, 2.436E-11, 2.465E-11, 2.208E-11, 2.036E-11, 2.521E-11, 5.386E-11, 5.197E-11, 5.234E-11, 3.970E-11, 4.059E-11, 3.353E-11, 3.917E-11, 5.742E-11, 5.989E-11, 4.101E-11, 4.749E-11, 5.308E-11, 4.630E-11, 6.608E-11, 6.948E-11, 6.199E-11, 7.711E-11, 7.305E-11, 6.944E-11, 6.858E-11, 4.971E-11, 4.672E-11, 5.267E-11, 4.590E-11, 3.997E-11, 6.056E-11, 6.353E-11, 5.787E-11, 5.215E-11, 4.317E-11, 5.865E-11, 7.464E-11, 4.972E-11, 3.893E-11, 5.074E-11, 4.334E-11, 2.032E-11, 1.578E-11
1.062E-11, 1.301E-11, 1.427E-11, 1.149E-11, 7.648E-12, 7.091E-12, 1.451E-11, 6.159E-11, 7.937E-11, 1.694E-11, 7.877E-12, 9.837E-12, 1.280E-11, 2.173E-11, 2.781E-11, 3.969E-11, 3.837E-11, 3.218E-11, 3.012E-11, 3.364E-11, 3.399E-11, 4.304E-11, 4.990E-11, 4.259E-11, 3.491E-11, 2.508E-11, 2.332E-11, 1.967E-11, 1.555E-11, 1.133E-11, 1.145E-11, 1.134E-11, 1.316E-11, 1.542E-11, 2.148E-11, 3.186E-11, 3.943E-11, 4.561E-11, 5.117E-11, 4.428E-11, 4.323E-11, 4.889E-11, 4.577E-11, 3.421E-11, 3.340E-11, 3.967E-11, 5.411E-11, 7.035E-11, 7.209E-11, 7.248E-11, 5.777E-11, 6.095E-11, 5.867E-11, 4.807E-11, 4.213E-11, 3.602E-11, 3.419E-11, 4.006E-11, 3.004E-11, 3.105E-11, 4.000E-11, 4.145E-11, 4.037E-11, 2.855E-11, 3.507E-11, 5.128E-11, 3.910E-11, 3.294E-11, 3.370E-11, 2.722E-11, 1.238E-11, 9.054E-12
1.117E-11, 1.108E-11, 1.070E-11, 1.141E-11, 1.721E-11, 3.113E-11, 2.197E-11, 1.247E-11, 8.901E-12, 7.375E-12, 7.412E-12, 7.618E-12, 1.026E-11, 1.673E-11, 2.830E-11, 3.769E-11, 2.912E-11, 2.109E-11, 2.436E-11, 2.847E-11, 2.660E-11, 2.963E-11, 2.821E-11, 2.644E-11, 1.918E-11, 1.710E-11, 1.601E-11, 1.233E-11, 1.177E-11, 8.585E-12, 9.046E-12, 1.283E-11, 1.117E-11, 1.125E-11, 1.714E-11, 1.752E-11, 3.067E-11, 3.538E-11, 3.651E-11, 4.160E-11, 4.090E-11, 3.903E-11, 4.168E-11, 4.480E-11, 4.829E-11, 3.862E-11, 3.864E-11, 4.976E-11, 5.409E-11, 5.675E-11, 5.607E-11, 4.966E-11, 4.329E-11, 3.306E-11, 3.103E-11, 3.198E-11, 3.719E-11, 3.375E-11, 2.673E-11, 2.345E-11, 2.407E-11, 2.440E-11, 1.949E-11, 1.343E-11, 1.215E-11, 1.694E-11, 2.173E-11, 3.194E-11, 3.881E-11, 2.915E-11, 1.847E-11, 1.229E-11
8.409E-12, 7.860E-12, 8.866E-12, 9.735E-12, 9.441E-12, 8.923E-12, 8.940E-12, 6.355E-12, 6.244E-12, 7.248E-12, 8.016E-12, 7.358E-12, 8.670E-12, 1.079E-11, 1.565E-11, 2.316E-11, 1.947E-11, 1.887E-11, 1.881E-11, 2.076E-11, 2.073E-11, 2.043E-11, 1.903E-11, 1.721E-11, 1.698E-11, 1.820E-11, 1.820E-11, 1.695E-11, 1.136E-11, 9.986E-12, 1.130E-11, 1.322E-11, 1.535E-11, 2.299E-11, 3.105E-11, 3.026E-11, 2.567E-11, 2.332E-11, 2.750E-11, 3.019E-11, 3.187E-11, 2.877E-11, 2.897E-11, 3.250E-11, 3.535E-11, 4.098E-11, 4.176E-11, 4.193E-11, 3.843E-11, 3.485E-11, 2.707E-11, 1.925E-11, 2.154E-11, 2.422E-11, 2.718E-11, 3.117E-11, 3.385E-11, 2.839E-11, 3.040E-11, 2.677E-11, 3.016E-11, 4.401E-11, 6.151E-11, 6.377E-11, 5.927E-11, 3.270E-11, 2.087E-11, 1.499E-11, 1.518E-11, 1.067E-11, 1.017E-11, 8.924E-12
9.855E-12, 1.187E-11, 1.330E-11, 1.259E-11, 1.147E-11, 1.057E-11, 1.005E-11, 9.155E-12, 9.187E-12, 7.833E-12, 7.826E-12, 1.038E-11, 1.286E-11, 1.411E-11, 1.483E-11, 1.429E-11, 1.618E-11, 1.859E-11, 1.804E-11, 1.721E-11, 1.668E-11, 1.514E-11, 1.339E-11, 1.258E-11, 1.171E-11, 1.421E-11, 1.657E-11, 1.659E-11, 1.330E-11, 1.011E-11, 1.019E-11, 1.145E-11, 1.425E-11, 1.743E-11, 1.706E-11, 1.723E-11, 1.722E-11, 1.813E-11, 1.774E-11, 1.956E-11, 2.276E-11, 2.649E-11, 2.733E-11, 2.884E-11, 3.479E-11, 3.912E-11, 3.406E-11, 2.787E-11, 2.268E-11, 2.107E-11, 2.077E-11, 2.188E-11, 2.415E-11, 2.750E-11, 2.921E-11, 2.767E-11, 2.462E-11, 2.257E-11, 2.356E-11, 3.190E-11, 3.595E-11, 3.574E-11, 4.087E-11, 4.553E-11, 4.484E-11, 2.910E-11, 1.486E-11, 1.388E-11, 1.231E-11, 1.100E-11, 9.699E-12, 8.352E-12
1.771E-11, 1.875E-11, 2.028E-11, 2.249E-11, 2.513E-11, 2.648E-11, 2.502E-11, 2.114E-11, 1.741E-11, 1.550E-11, 1.489E-11, 1.398E-11, 1.409E-11, 1.377E-11, 1.310E-11, 1.323E-11, 1.361E-11, 1.554E-11, 1.614E-11, 1.704E-11, 1.855E-11, 1.763E-11, 1.425E-11, 1.343E-11, 1.325E-11, 1.361E-11, 1.355E-11, 1.360E-11, 1.745E-11, 2.478E-11, 2.456E-11, 2.239E-11, 1.775E-11, 1.567E-11, 1.565E-11, 1.619E-11, 1.652E-11, 1.716E-11, 1.987E-11, 2.348E-11, 2.602E-11, 2.587E-11, 2.341E-11, 2.126E-11, 2.016E-11, 2.044E-11, 2.004E-11, 1.956E-11, 2.048E-11, 2.573E-11, 2.957E-11, 2.997E-11, 2.994E-11, 2.939E-11, 2.949E-11, 2.989E-11, 3.035E-11, 3.518E-11, 3.997E-11, 3.959E-11, 3.374E-11, 2.767E-11, 2.642E-11, 2.374E-11, 1.998E-11, 1.603E-11, 1.535E-11, 1.577E-11, 1.565E-11, 1.516E-11, 1.490E-11, 1.637E-11
2.292E-11, 2.368E-11, 2.401E-11, 2.354E-11, 2.300E-11, 2.280E-11, 2.282E-11, 2.281E-11, 2.278E-11, 2.271E-11, 2.241E-11, 2.087E-11, 1.869E-11, 1.754E-11, 1.739E-11, 1.723E-11, 1.700E-11, 1.681E-11, 1.694E-11, 1.741E-11, 1.619E-11, 1.429E-11, 1.336E-11, 1.314E-11, 1.276E-11, 1.241E-11, 1.178E-11, 1.089E-11, 1.065E-11, 1.053E-11, 1.132E-11, 1.258E-11, 1.356E-11, 1.384E-11, 1.433E-11, 1.778E-11, 2.140E-11, 2.250E-11, 2.336E-11, 2.312E-11, 2.169E-11, 2.055E-11, 2.057E-11, 1.926E-11, 1.768E-11, 1.506E-11, 1.397E-11, 1.509E-11, 1.643E-11, 1.931E-11, 2.142E-11, 2.375E-11, 2.740E-11, 3.111E-11, 3.233E-11, 3.279E-11, 3.091E-11, 2.889E-11, 2.696E-11, 2.574E-11, 2.465E-11, 2.354E-11, 2.299E-11, 2.284E-11, 2.223E-11, 2.216E-11, 2.279E-11, 2.304E-11, 2.294E-11, 2.240E-11, 2.247E-11, 2.244E-11
1.790E-11, 1.800E-11, 1.886E-11, 1.977E-11, 2.072E-11, 2.127E-11, 2.147E-11, 2.152E-11, 2.141E-11, 2.107E-11, 2.070E-11, 2.005E-11, 1.911E-11, 1.834E-11, 1.798E-11, 1.809E-11, 1.829E-11, 1.842E-11, 1.863E-11, 1.892E-11, 1.911E-11, 1.907E-11, 1.842E-11, 1.753E-11, 1.643E-11, 1.531E-11, 1.486E-11, 1.605E-11, 1.663E-11, 1.748E-11, 1.922E-11, 2.097E-11, 2.235E-11, 2.299E-11, 2.456E-11, 2.581E-11, 2.668E-11, 2.687E-11, 2.690E-11, 2.690E-11, 2.662E-11, 2.594E-11, 2.431E-11, 2.221E-11, 2.081E-11, 1.992E-11, 1.859E-11, 1.779E-11, 1.718E-11, 1.690E-11, 1.723E-11, 1.779E-11, 1.845E-11, 1.924E-11, 1.997E-11, 2.096E-11, 2.170E-11, 2.193E-11, 2.122E-11, 2.095E-11, 2.019E-11, 1.979E-11, 1.966E-11, 1.949E-11, 1.965E-11, 1.984E-11, 1.996E-11, 2.008E-11, 1.984E-11, 1.955E-11, 1.888E-11, 1.819E-11
1.875E-11, 1.893E-11, 1.913E-11, 1.934E-11, 1.956E-11, 1.978E-11, 2.001E-11, 2.023E-11, 2.046E-11, 2.067E-11, 2.115E-11, 2.135E-11, 2.154E-11, 2.172E-11, 2.189E-11, 2.204E-11, 2.217E-11, 2.227E-11, 2.236E-11, 2.243E-11, 2.248E-11, 2.191E-11, 2.200E-11, 2.200E-11, 2.200E-11, 2.197E-11, 2.193E-11, 2.185E-11, 2.174E-11, 2.157E-11, 2.132E-11, 2.096E-11, 2.049E-11, 1.990E-11, 1.926E-11, 1.863E-11, 1.772E-11, 1.721E-11, 1.684E-11, 1.660E-11, 1.645E-11, 1.636E-11, 1.633E-11, 1.633E-11, 1.635E-11, 1.640E-11, 1.689E-11, 1.693E-11, 1.697E-11, 1.702E-11, 1.708E-11, 1.713E-11, 1.716E-11, 1.723E-11, 1.729E-11, 1.736E-11, 1.742E-11, 1.748E-11, 1.755E-11, 1.761E-11, 1.755E-11, 1.760E-11, 1.765E-11, 1.770E-11, 1.776E-11, 1.782E-11, 1.789E-11, 1.796E-11, 1.805E-11, 1.815E-11, 1.845E-11, 1.859E-11