5.862E-12, 5.885E-12, 5.902E-12, 5.915E-12, 5.925E-12, 5.897E-12, 5.902E-12, 5.906E-12, 5.910E-12, 5.915E-12, 5.918E-12, 5.922E-12, 5.922E-12, 5.922E-12, 5.920E-12, 5.918E-12, 5.913E-12, 5.907E-12, 5.897E-12, 5.888E-12, 5.876E-12, 5.810E-12, 5.799E-12, 5.786E-12, 5.772E-12, 5.758E-12, 5.743E-12, 5.726E-12, 5.708E-12, 5.720E-12, 5.698E-12, 5.670E-12, 5.634E-12, 5.591E-12, 5.538E-12, 5.479E-12, 5.347E-12, 5.279E-12, 5.218E-12, 5.169E-12, 5.132E-12, 5.107E-12, 5.093E-12, 5.084E-12, 5.081E-12, 5.083E-12, 5.087E-12, 5.133E-12, 5.140E-12, 5.202E-12, 5.213E-12, 5.227E-12, 5.244E-12, 5.248E-12, 5.272E-12, 5.301E-12, 5.335E-12, 5.373E-12, 5.415E-12, 5.459E-12, 5.503E-12, 5.546E-12, 5.587E-12, 5.626E-12, 5.587E-12, 5.621E-12, 5.657E-12, 5.694E-12, 5.731E-12, 5.768E-12, 5.803E-12, 5.835E-12
1.041E-11, 1.042E-11, 1.037E-11, 1.038E-11, 1.039E-11, 1.038E-11, 1.031E-11, 9.733E-12, 8.142E-12, 7.607E-12, 7.572E-12, 7.581E-12, 7.592E-12, 7.605E-12, 7.628E-12, 7.711E-12, 7.844E-12, 8.053E-12, 8.333E-12, 8.576E-12, 8.835E-12, 8.811E-12, 8.561E-12, 8.153E-12, 7.676E-12, 7.308E-12, 7.029E-12, 6.788E-12, 6.552E-12, 6.497E-12, 6.609E-12, 6.565E-12, 6.533E-12, 6.472E-12, 6.162E-12, 5.326E-12, 4.895E-12, 4.849E-12, 4.844E-12, 4.844E-12, 4.844E-12, 4.846E-12, 4.848E-12, 4.851E-12, 4.862E-12, 4.905E-12, 5.030E-12, 5.121E-12, 5.127E-12, 5.119E-12, 5.112E-12, 5.109E-12, 5.111E-12, 5.142E-12, 5.173E-12, 5.223E-12, 5.282E-12, 5.358E-12, 5.541E-12, 5.672E-12, 5.801E-12, 5.896E-12, 5.876E-12, 5.994E-12, 6.451E-12, 7.686E-12, 8.879E-12, 9.367E-12, 9.597E-12, 9.792E-12, 1.020E-11, 1.029E-11
1.181E-11, 1.185E-11, 1.169E-11, 1.163E-11, 1.142E-11, 1.099E-11, 1.068E-11, 1.043E-11, 8.785E-12, 7.340E-12, 7.005E-12, 6.739E-12, 6.672E-12, 6.679E-12, 6.601E-12, 6.572E-12, 6.638E-12, 6.755E-12, 6.945E-12, 7.311E-12, 7.525E-12, 7.703E-12, 7.898E-12, 8.066E-12, 8.049E-12, 7.925E-12, 7.829E-12, 7.703E-12, 7.431E-12, 6.792E-12, 6.431E-12, 6.171E-12, 5.792E-12, 5.377E-12, 5.133E-12, 4.935E-12, 4.880E-12, 4.908E-12, 4.969E-12, 5.255E-12, 5.511E-12, 5.513E-12, 5.404E-12, 5.349E-12, 5.363E-12, 5.397E-12, 5.546E-12, 5.942E-12, 6.760E-12, 7.194E-12, 7.394E-12, 7.465E-12, 7.327E-12, 6.722E-12, 6.081E-12, 5.959E-12, 5.894E-12, 5.826E-12, 5.653E-12, 5.554E-12, 5.493E-12, 5.438E-12, 5.475E-12, 5.574E-12, 5.772E-12, 5.944E-12, 6.413E-12, 7.221E-12, 9.033E-12, 1.013E-11, 1.027E-11, 1.115E-11
1.220E-11, 1.206E-11, 1.194E-11, 1.193E-11, 1.150E-11, 1.107E-11, 1.099E-11, 1.075E-11, 1.022E-11, 9.617E-12, 9.185E-12, 9.098E-12, 8.260E-12, 8.087E-12, 8.135E-12, 8.150E-12, 8.106E-12, 8.016E-12, 8.042E-12, 7.979E-12, 7.810E-12, 7.655E-12, 7.479E-12, 7.492E-12, 7.607E-12, 7.705E-12, 7.706E-12, 7.686E-12, 7.590E-12, 7.338E-12, 6.927E-12, 6.489E-12, 6.199E-12, 5.990E-12, 5.794E-12, 6.008E-12, 6.525E-12, 7.540E-12, 7.924E-12, 7.312E-12, 6.571E-12, 5.972E-12, 5.435E-12, 5.648E-12, 5.866E-12, 5.986E-12, 6.768E-12, 6.908E-12, 6.858E-12, 6.732E-12, 6.709E-12, 6.777E-12, 6.978E-12, 6.965E-12, 6.918E-12, 7.115E-12, 7.613E-12, 8.017E-12, 8.122E-12, 8.283E-12, 8.083E-12, 7.235E-12, 7.054E-12, 7.073E-12, 7.110E-12, 8.259E-12, 9.317E-12, 9.353E-12, 9.370E-12, 9.796E-12, 1.160E-11, 1.203E-11
1.305E-11, 1.250E-11, 1.241E-11, 1.235E-11, 1.251E-11, 1.256E-11, 1.225E-11, 1.210E-11, 1.200E-11, 1.190E-11, 1.181E-11, 1.174E-11, 1.177E-11, 1.187E-11, 1.199E-11, 1.108E-11, 1.011E-11, 9.741E-12, 9.413E-12, 9.010E-12, 8.992E-12, 8.299E-12, 8.251E-12, 8.252E-12, 7.729E-12, 7.141E-12, 7.150E-12, 7.443E-12, 7.668E-12, 7.565E-12, 7.350E-12, 6.962E-12, 6.898E-12, 7.772E-12, 8.649E-12, 8.578E-12, 8.536E-12, 8.444E-12, 8.365E-12, 8.416E-12, 9.083E-12, 9.019E-12, 8.695E-12, 8.538E-12, 8.690E-12, 8.526E-12, 8.402E-12, 9.089E-12, 9.804E-12, 1.006E-11, 1.017E-11, 1.009E-11, 9.964E-12, 9.931E-12, 1.032E-11, 1.090E-11, 1.104E-11, 1.079E-11, 1.067E-11, 1.134E-11, 1.201E-11, 1.169E-11, 1.128E-11, 1.096E-11, 1.078E-11, 1.074E-11, 1.129E-11, 1.187E-11, 1.200E-11, 1.188E-11, 1.264E-11, 1.332E-11
1.073E-11, 1.064E-11, 1.093E-11, 1.125E-11, 1.150E-11, 1.189E-11, 1.131E-11, 1.099E-11, 1.152E-11, 1.205E-11, 1.202E-11, 1.163E-11, 1.163E-11, 1.150E-11, 1.103E-11, 1.095E-11, 1.099E-11, 1.099E-11, 1.101E-11, 1.097E-11, 1.070E-11, 9.894E-12, 9.061E-12, 8.817E-12, 8.284E-12, 8.050E-12, 8.021E-12, 7.657E-12, 7.197E-12, 6.864E-12, 6.764E-12, 6.786E-12, 7.508E-12, 7.596E-12, 7.821E-12, 8.125E-12, 8.442E-12, 9.070E-12, 9.694E-12, 9.696E-12, 9.664E-12, 9.997E-12, 1.028E-11, 1.026E-11, 9.933E-12, 9.936E-12, 9.935E-12, 1.041E-11, 1.042E-11, 1.048E-11, 1.073E-11, 1.095E-11, 1.086E-11, 1.079E-11, 1.080E-11, 1.166E-11, 1.168E-11, 1.214E-11, 1.298E-11, 1.418E-11, 1.372E-11, 1.279E-11, 1.334E-11, 1.368E-11, 1.302E-11, 1.298E-11, 1.150E-11, 1.145E-11, 1.142E-11, 1.165E-11, 1.177E-11, 1.127E-11
1.081E-11, 1.145E-11, 1.159E-11, 1.189E-11, 1.164E-11, 1.160E-11, 1.164E-11, 1.174E-11, 1.175E-11, 1.150E-11, 1.148E-11, 1.008E-11, 1.008E-11, 1.019E-11, 9.869E-12, 9.747E-12, 1.009E-11, 1.047E-11, 1.061E-11, 1.003E-11, 9.527E-12, 9.281E-12, 9.281E-12, 9.182E-12, 8.838E-12, 8.846E-12, 8.810E-12, 8.483E-12, 8.041E-12, 7.681E-12, 7.551E-12, 7.422E-12, 7.423E-12, 7.426E-12, 7.441E-12, 7.594E-12, 8.095E-12, 8.521E-12, 8.931E-12, 9.313E-12, 9.239E-12, 9.152E-12, 1.019E-11, 1.123E-11, 1.121E-11, 1.008E-11, 1.009E-11, 1.019E-11, 1.036E-11, 1.041E-11, 1.025E-11, 1.045E-11, 1.064E-11, 1.090E-11, 1.132E-11, 1.165E-11, 1.127E-11, 1.157E-11, 1.247E-11, 1.264E-11, 1.236E-11, 1.186E-11, 1.206E-11, 1.208E-11, 1.224E-11, 1.172E-11, 1.120E-11, 1.111E-11, 1.113E-11, 1.113E-11, 1.098E-11, 1.066E-11
1.052E-11, 1.107E-11, 1.162E-11, 1.117E-11, 1.107E-11, 1.109E-11, 1.138E-11, 1.137E-11, 1.091E-11, 1.040E-11, 1.005E-11, 9.641E-12, 9.771E-12, 9.893E-12, 9.935E-12, 9.861E-12, 9.841E-12, 9.323E-12, 9.362E-12, 9.487E-12, 9.243E-12, 8.977E-12, 9.253E-12, 9.123E-12, 9.677E-12, 9.120E-12, 9.264E-12, 9.372E-12, 8.993E-12, 8.646E-12, 8.258E-12, 7.967E-12, 7.653E-12, 7.339E-12, 7.472E-12, 7.511E-12, 7.570E-12, 7.484E-12, 7.441E-12, 8.022E-12, 8.575E-12, 9.204E-12, 9.977E-12, 1.024E-11, 1.019E-11, 1.037E-11, 1.031E-11, 1.015E-11, 1.000E-11, 9.814E-12, 9.292E-12, 9.408E-12, 9.583E-12, 9.797E-12, 1.030E-11, 1.047E-11, 1.062E-11, 1.079E-11, 1.094E-11, 1.052E-11, 1.047E-11, 1.033E-11, 1.003E-11, 1.049E-11, 1.071E-11, 1.076E-11, 1.106E-11, 1.123E-11, 1.109E-11, 1.127E-11, 1.134E-11, 1.028E-11
1.314E-11, 1.169E-11, 1.185E-11, 1.203E-11, 1.223E-11, 1.171E-11, 1.161E-11, 1.145E-11, 1.139E-11, 1.070E-11, 1.044E-11, 1.017E-11, 1.007E-11, 9.840E-12, 9.584E-12, 9.327E-12, 9.557E-12, 9.526E-12, 1.027E-11, 1.015E-11, 8.797E-12, 8.355E-12, 9.243E-12, 1.027E-11, 1.050E-11, 1.119E-11, 1.035E-11, 9.451E-12, 9.283E-12, 1.023E-11, 9.119E-12, 8.458E-12, 8.389E-12, 8.354E-12, 8.493E-12, 8.321E-12, 7.934E-12, 7.732E-12, 7.645E-12, 7.771E-12, 7.905E-12, 8.794E-12, 8.844E-12, 9.096E-12, 9.034E-12, 8.848E-12, 9.295E-12, 8.944E-12, 8.910E-12, 9.379E-12, 9.241E-12, 9.521E-12, 1.007E-11, 1.037E-11, 1.115E-11, 1.146E-11, 1.107E-11, 1.153E-11, 1.101E-11, 1.084E-11, 1.037E-11, 9.359E-12, 9.249E-12, 9.483E-12, 9.586E-12, 1.075E-11, 9.807E-12, 1.105E-11, 1.208E-11, 1.141E-11, 1.152E-11, 1.232E-11
1.188E-11, 1.270E-11, 1.182E-11, 1.093E-11, 1.171E-11, 1.203E-11, 1.136E-11, 1.068E-11, 1.168E-11, 1.175E-11, 1.186E-11, 1.234E-11, 1.180E-11, 1.124E-11, 9.808E-12, 8.392E-12, 8.774E-12, 8.976E-12, 9.325E-12, 9.302E-12, 9.991E-12, 9.039E-12, 9.562E-12, 1.301E-11, 1.546E-11, 1.207E-11, 1.158E-11, 1.121E-11, 1.025E-11, 1.037E-11, 8.883E-12, 8.788E-12, 8.902E-12, 9.025E-12, 8.887E-12, 9.271E-12, 9.717E-12, 9.486E-12, 9.775E-12, 9.810E-12, 9.520E-12, 9.888E-12, 8.963E-12, 9.348E-12, 1.002E-11, 9.560E-12, 9.392E-12, 8.264E-12, 9.511E-12, 1.102E-11, 8.829E-12, 8.640E-12, 9.274E-12, 1.008E-11, 9.691E-12, 9.965E-12, 1.057E-11, 1.040E-11, 1.047E-11, 1.090E-11, 1.116E-11, 1.136E-11, 1.085E-11, 1.175E-11, 1.101E-11, 1.066E-11, 1.154E-11, 1.594E-11, 1.631E-11, 1.272E-11, 1.018E-11, 1.143E-11
1.149E-11, 1.255E-11, 1.237E-11, 1.161E-11, 1.170E-11, 1.169E-11, 1.186E-11, 1.198E-11, 1.313E-11, 1.234E-11, 1.161E-11, 1.098E-11, 1.050E-11, 9.896E-12, 9.523E-12, 9.098E-12, 8.425E-12, 8.727E-12, 8.538E-12, 8.515E-12, 8.971E-12, 9.512E-12, 1.096E-11, 1.889E-11, 1.895E-11, 1.551E-11, 1.270E-11, 1.158E-11, 1.180E-11, 1.020E-11, 8.144E-12, 7.564E-12, 7.260E-12, 7.539E-12, 7.883E-12, 7.858E-12, 8.050E-12, 8.837E-12, 8.868E-12, 9.555E-12, 8.699E-12, 9.433E-12, 1.148E-11, 1.104E-11, 1.359E-11, 1.312E-11, 1.123E-11, 8.506E-12, 7.238E-12, 7.492E-12, 7.410E-12, 6.939E-12, 7.830E-12, 1.152E-11, 9.121E-12, 9.013E-12, 9.062E-12, 9.629E-12, 9.251E-12, 1.080E-11, 1.257E-11, 1.289E-11, 1.229E-11, 1.161E-11, 1.709E-11, 2.269E-11, 2.080E-11, 1.789E-11, 1.497E-11, 1.157E-11, 9.807E-12, 1.091E-11
1.071E-11, 1.119E-11, 1.144E-11, 1.156E-11, 1.212E-11, 9.616E-12, 1.043E-11, 1.113E-11, 1.269E-11, 1.209E-11, 1.039E-11, 9.280E-12, 1.038E-11, 1.115E-11, 9.875E-12, 9.611E-12, 8.848E-12, 7.834E-12, 7.574E-12, 7.932E-12, 7.728E-12, 8.307E-12, 1.207E-11, 2.092E-11, 1.681E-11, 1.253E-11, 8.732E-12, 7.041E-12, 7.192E-12, 8.313E-12, 7.327E-12, 6.547E-12, 5.844E-12, 5.382E-12, 5.468E-12, 5.643E-12, 6.836E-12, 7.368E-12, 8.575E-12, 1.043E-11, 1.267E-11, 2.344E-11, 2.945E-11, 2.001E-11, 1.573E-11, 1.110E-11, 9.407E-12, 9.011E-12, 6.327E-12, 5.855E-12, 6.981E-12, 7.056E-12, 7.140E-12, 8.031E-12, 8.200E-12, 9.043E-12, 1.077E-11, 9.220E-12, 1.037E-11, 1.497E-11, 2.063E-11, 1.920E-11, 1.473E-11, 1.753E-11, 2.167E-11, 2.241E-11, 2.124E-11, 1.934E-11, 1.649E-11, 1.280E-11, 1.110E-11, 1.082E-11
9.924E-12, 8.562E-12, 1.330E-11, 1.025E-11, 1.186E-11, 1.235E-11, 9.737E-12, 9.588E-12, 8.376E-12, 9.599E-12, 9.201E-12, 9.091E-12, 8.876E-12, 9.151E-12, 8.940E-12, 8.576E-12, 7.907E-12, 7.467E-12, 6.723E-12, 6.134E-12, 6.767E-12, 6.236E-12, 7.663E-12, 1.191E-11, 1.137E-11, 8.354E-12, 6.565E-12, 6.355E-12, 6.553E-12, 6.095E-12, 5.227E-12, 3.638E-12, 3.213E-12, 4.290E-12, 5.287E-12, 6.074E-12, 5.077E-12, 6.291E-12, 6.475E-12, 8.963E-12, 1.456E-11, 6.608E-11, 4.742E-11, 3.938E-11, 1.667E-11, 1.456E-11, 1.126E-11, 1.145E-11, 5.889E-12, 6.020E-12, 6.158E-12, 7.210E-12, 7.183E-12, 8.225E-12, 8.793E-12, 8.703E-12, 9.285E-12, 9.296E-12, 9.892E-12, 1.253E-11, 1.256E-11, 1.495E-11, 1.144E-11, 1.380E-11, 1.453E-11, 1.269E-11, 1.273E-11, 1.275E-11, 9.002E-12, 1.092E-11, 9.810E-12, 9.740E-12
8.405E-12, 9.617E-12, 8.840E-12, 1.019E-11, 9.163E-12, 8.529E-12, 8.875E-12, 6.831E-12, 5.977E-12, 8.687E-12, 8.722E-12, 9.330E-12, 8.656E-12, 7.285E-12, 7.314E-12, 7.088E-12, 7.613E-12, 6.025E-12, 5.056E-12, 4.942E-12, 7.080E-12, 9.135E-12, 7.377E-12, 6.646E-12, 7.169E-12, 8.176E-12, 7.672E-12, 1.009E-11, 9.036E-12, 9.692E-12, 5.817E-12, 5.029E-12, 2.615E-12, 3.251E-12, 3.570E-12, 5.501E-12, 5.957E-12, 6.181E-12, 5.965E-12, 4.513E-12, 7.777E-12, 2.187E-11, 2.448E-11, 3.531E-11, 1.208E-11, 1.291E-11, 1.097E-11, 1.013E-11, 7.743E-12, 6.545E-12, 7.171E-12, 7.687E-12, 9.392E-12, 1.233E-11, 1.112E-11, 6.384E-12, 6.076E-12, 7.258E-12, 9.677E-12, 1.148E-11, 1.084E-11, 1.411E-11, 1.444E-11, 1.147E-11, 8.522E-12, 5.781E-12, 7.899E-12, 7.749E-12, 6.058E-12, 7.273E-12, 7.817E-12, 7.643E-12
6.816E-12, 7.170E-12, 7.554E-12, 8.304E-12, 7.722E-12, 8.056E-12, 7.680E-12, 4.246E-12, 3.545E-12, 5.967E-12, 8.013E-12, 9.568E-12, 1.019E-11, 9.573E-12, 8.973E-12, 9.654E-12, 5.397E-12, 3.864E-12, 3.079E-12, 3.947E-12, 6.539E-12, 6.751E-12, 5.038E-12, 5.693E-12, 7.073E-12, 1.181E-11, 7.856E-12, 9.525E-12, 8.769E-12, 5.925E-12, 4.360E-12, 3.490E-12, 3.158E-12, 3.025E-12, 4.625E-12, 4.104E-12, 4.488E-12, 9.591E-12, 6.433E-12, 5.776E-12, 5.860E-12, 6.163E-12, 3.066E-12, 1.045E-11, 2.747E-12, 4.320E-12, 7.923E-12, 8.874E-12, 7.876E-12, 8.697E-12, 9.691E-12, 9.685E-12, 8.827E-12, 7.778E-12, 5.455E-12, 5.422E-12, 5.987E-12, 6.961E-12, 6.816E-12, 7.621E-12, 7.384E-12, 8.687E-12, 6.984E-12, 5.429E-12, 3.627E-12, 4.623E-12, 4.537E-12, 3.138E-12, 3.095E-12, 5.279E-12, 5.305E-12, 6.670E-12
4.576E-12, 5.623E-12, 5.627E-12, 4.789E-12, 5.731E-12, 6.752E-12, 5.549E-12, 5.421E-12, 5.918E-12, 6.083E-12, 1.022E-11, 1.176E-11, 1.334E-11, 1.220E-11, 7.461E-12, 6.576E-12, 5.684E-12, 3.333E-12, 1.225E-12, 1.565E-12, 1.935E-12, 1.987E-12, 2.009E-12, 2.000E-12, 3.452E-12, 5.850E-12, 5.042E-12, 7.900E-12, 9.076E-12, 9.248E-12, 7.755E-12, 4.529E-12, 4.181E-12, 2.742E-12, 2.973E-12, 2.862E-12, 2.764E-12, 3.713E-12, 1.196E-12, 2.100E-12, 2.708E-12, 3.395E-12, 3.045E-12, 2.418E-12, 1.967E-12, 3.323E-12, 4.773E-12, 4.986E-12, 6.833E-12, 8.729E-12, 9.606E-12, 7.898E-12, 8.595E-12, 7.045E-12, 6.368E-12, 5.073E-12, 5.928E-12, 5.190E-12, 5.035E-12, 3.904E-12, 3.839E-12, 4.550E-12, 3.462E-12, 2.074E-12, 2.430E-12, 2.626E-12, 3.489E-12, 1.845E-12, 2.361E-12, 2.339E-12, 3.365E-12, 4.787E-12
4.726E-12, 6.501E-12, 8.355E-12, 9.473E-12, 1.058E-11, 1.312E-11, 1.249E-11, 1.397E-11, 1.026E-11, 8.388E-12, 1.240E-11, 1.519E-11, 1.111E-11, 9.323E-12, 8.083E-12, 6.811E-12, 4.207E-12, 2.488E-12, 1.780E-12, 2.807E-12, 4.248E-12, 3.540E-12, 4.122E-12, 3.908E-12, 2.388E-12, 2.232E-12, 2.543E-12, 3.314E-12, 1.186E-11, 1.173E-11, 8.016E-12, 7.197E-12, 4.957E-12, 3.699E-12, 3.140E-12, 2.251E-12, 2.320E-12, 2.458E-12, 1.441E-12, 2.482E-12, 3.603E-12, 3.747E-12, 3.459E-12, 2.780E-12, 3.199E-12, 4.496E-12, 3.276E-12, 3.491E-12, 4.638E-12, 4.376E-12, 6.278E-12, 6.596E-12, 5.398E-12, 5.957E-12, 3.674E-12, 3.344E-12, 3.271E-12, 6.129E-12, 8.585E-12, 5.586E-12, 4.935E-12, 5.163E-12, 4.404E-12, 4.488E-12, 3.611E-12, 3.395E-12, 1.974E-12, 2.116E-12, 4.500E-12, 3.881E-12, 5.496E-12, 4.577E-12
1.299E-11, 1.389E-11, 1.766E-11, 1.888E-11, 1.712E-11, 1.371E-11, 1.752E-11, 1.203E-11, 9.360E-12, 7.233E-12, 8.148E-12, 7.890E-12, 4.119E-12, 4.527E-12, 4.766E-12, 4.179E-12, 1.072E-12, 1.895E-12, 2.180E-12, 4.555E-12, 4.167E-12, 3.961E-12, 4.746E-12, 3.635E-12, 3.036E-12, 2.744E-12, 2.151E-12, 3.449E-12, 8.878E-12, 9.739E-12, 1.014E-11, 6.799E-12, 5.470E-12, 4.139E-12, 3.043E-12, 3.353E-12, 4.518E-12, 6.625E-12, 8.130E-12, 2.498E-11, 8.813E-12, 6.295E-12, 3.464E-12, 4.689E-12, 5.680E-12, 5.319E-12, 3.397E-12, 2.716E-12, 2.765E-12, 2.329E-12, 2.986E-12, 3.436E-12, 3.650E-12, 2.896E-12, 2.217E-12, 2.329E-12, 3.205E-12, 5.711E-12, 7.987E-12, 8.583E-12, 5.940E-12, 4.944E-12, 5.888E-12, 6.572E-12, 5.884E-12, 5.514E-12, 6.558E-12, 5.877E-12, 7.851E-12, 8.559E-12, 1.191E-11, 1.133E-11
2.014E-11, 1.889E-11, 1.954E-11, 1.887E-11, 1.764E-11, 1.256E-11, 1.082E-11, 7.222E-12, 4.952E-12, 3.640E-12, 3.045E-12, 2.319E-12, 2.227E-12, 1.997E-12, 1.995E-12, 2.373E-12, 1.814E-12, 1.847E-12, 1.319E-12, 1.651E-12, 2.341E-12, 3.499E-12, 5.143E-12, 5.292E-12, 3.374E-12, 4.151E-12, 6.440E-12, 6.289E-12, 8.189E-12, 1.289E-11, 1.141E-11, 9.475E-12, 9.417E-12, 1.375E-11, 1.283E-11, 1.384E-11, 2.015E-11, 4.494E-11, 2.585E-11, 3.533E-11, 2.615E-11, 1.650E-11, 1.650E-11, 6.086E-12, 5.498E-12, 5.863E-12, 4.964E-12, 3.377E-12, 3.482E-12, 3.752E-12, 4.680E-12, 6.801E-12, 6.043E-12, 4.484E-12, 4.908E-12, 8.694E-12, 1.109E-11, 7.952E-12, 7.444E-12, 7.791E-12, 7.313E-12, 7.582E-12, 9.301E-12, 1.065E-11, 1.323E-11, 1.428E-11, 1.180E-11, 1.071E-11, 1.546E-11, 1.728E-11, 2.025E-11, 2.107E-11
1.869E-11, 1.900E-11, 1.853E-11, 1.575E-11, 1.362E-11, 1.392E-11, 1.203E-11, 1.002E-11, 7.879E-12, 6.121E-12, 6.601E-12, 7.312E-12, 4.823E-12, 5.900E-12, 9.760E-12, 7.122E-12, 5.255E-12, 4.825E-12, 3.639E-12, 5.364E-12, 4.895E-12, 4.711E-12, 7.049E-12, 6.141E-12, 5.984E-12, 9.950E-12, 1.193E-11, 1.158E-11, 1.480E-11, 1.541E-11, 1.986E-11, 2.448E-11, 3.036E-11, 2.687E-11, 2.421E-11, 2.452E-11, 4.088E-11, 3.869E-11, 4.739E-11, 4.214E-11, 3.327E-11, 2.380E-11, 1.644E-11, 1.221E-11, 5.986E-12, 5.691E-12, 5.063E-12, 5.803E-12, 7.264E-12, 7.682E-12, 1.002E-11, 1.072E-11, 7.158E-12, 8.702E-12, 9.186E-12, 8.311E-12, 8.195E-12, 9.054E-12, 8.299E-12, 9.520E-12, 1.163E-11, 1.209E-11, 1.271E-11, 1.262E-11, 1.294E-11, 1.379E-11, 1.453E-11, 1.504E-11, 1.656E-11, 1.608E-11, 1.560E-11, 1.787E-11
1.228E-11, 1.617E-11, 1.069E-11, 1.266E-11, 1.031E-11, 9.021E-12, 1.243E-11, 1.238E-11, 1.250E-11, 1.817E-11, 1.821E-11, 2.828E-11, 1.572E-11, 1.361E-11, 9.662E-12, 7.516E-12, 5.779E-12, 9.423E-12, 6.573E-12, 7.896E-12, 6.924E-12, 8.450E-12, 1.248E-11, 1.024E-11, 9.022E-12, 7.493E-12, 9.618E-12, 1.213E-11, 1.494E-11, 1.487E-11, 1.946E-11, 2.886E-11, 3.704E-11, 4.491E-11, 3.247E-11, 3.054E-11, 2.163E-11, 2.017E-11, 2.653E-11, 2.703E-11, 2.950E-11, 2.914E-11, 2.188E-11, 2.398E-11, 1.301E-11, 7.715E-12, 8.255E-12, 8.803E-12, 6.473E-12, 6.157E-12, 8.125E-12, 2.222E-11, 2.184E-11, 1.278E-11, 1.021E-11, 1.031E-11, 1.259E-11, 9.205E-12, 9.079E-12, 1.579E-11, 1.623E-11, 1.155E-11, 1.085E-11, 1.112E-11, 1.373E-11, 1.449E-11, 1.289E-11, 1.393E-11, 1.896E-11, 2.512E-11, 2.004E-11, 1.131E-11
3.460E-11, 1.587E-11, 1.316E-11, 1.533E-11, 1.333E-11, 1.153E-11, 1.361E-11, 1.424E-11, 1.729E-11, 1.728E-11, 1.971E-11, 2.053E-11, 1.258E-11, 1.170E-11, 9.712E-12, 1.077E-11, 1.547E-11, 1.343E-11, 9.455E-12, 1.183E-11, 1.021E-11, 1.114E-11, 1.162E-11, 8.881E-12, 1.265E-11, 1.238E-11, 1.173E-11, 1.439E-11, 1.463E-11, 1.501E-11, 1.219E-11, 2.062E-11, 2.267E-11, 2.211E-11, 3.046E-11, 2.917E-11, 2.356E-11, 2.296E-11, 1.926E-11, 1.843E-11, 1.833E-11, 1.996E-11, 1.995E-11, 1.869E-11, 1.924E-11, 1.471E-11, 1.088E-11, 1.220E-11, 1.326E-11, 1.046E-11, 1.051E-11, 1.763E-11, 1.545E-11, 3.192E-11, 2.536E-11, 2.446E-11, 1.324E-11, 1.629E-11, 1.714E-11, 1.789E-11, 1.479E-11, 1.279E-11, 1.570E-11, 1.074E-11, 9.715E-12, 1.104E-11, 8.950E-12, 1.091E-11, 1.163E-11, 1.877E-11, 2.947E-11, 1.766E-11
2.028E-11, 2.293E-11, 2.563E-11, 2.166E-11, 2.134E-11, 1.966E-11, 2.118E-11, 1.967E-11, 1.363E-11, 1.465E-11, 2.510E-11, 2.510E-11, 2.052E-11, 1.957E-11, 1.502E-11, 1.719E-11, 2.734E-11, 4.943E-11, 4.904E-11, 3.242E-11, 2.142E-11, 1.459E-11, 1.472E-11, 1.516E-11, 1.684E-11, 1.881E-11, 1.730E-11, 1.917E-11, 1.666E-11, 1.092E-11, 1.116E-11, 1.423E-11, 1.697E-11, 1.694E-11, 1.515E-11, 1.371E-11, 1.445E-11, 1.370E-11, 1.331E-11, 1.306E-11, 1.526E-11, 1.899E-11, 1.615E-11, 1.540E-11, 1.648E-11, 1.857E-11, 2.116E-11, 1.855E-11, 1.696E-11, 1.745E-11, 2.278E-11, 2.765E-11, 3.419E-11, 3.448E-11, 3.783E-11, 3.623E-11, 2.936E-11, 3.195E-11, 3.131E-11, 2.670E-11, 1.757E-11, 1.888E-11, 1.722E-11, 2.068E-11, 1.697E-11, 1.536E-11, 2.111E-11, 1.873E-11, 2.142E-11, 2.815E-11, 1.846E-11, 1.791E-11
3.532E-11, 4.319E-11, 4.483E-11, 2.863E-11, 3.191E-11, 3.148E-11, 2.934E-11, 1.454E-11, 1.460E-11, 1.720E-11, 1.644E-11, 1.553E-11, 1.512E-11, 1.734E-11, 1.501E-11, 1.341E-11, 1.845E-11, 2.857E-11, 3.669E-11, 3.640E-11, 2.430E-11, 2.424E-11, 1.698E-11, 1.501E-11, 2.027E-11, 1.840E-11, 2.002E-11, 1.626E-11, 1.860E-11, 1.429E-11, 1.049E-11, 1.269E-11, 1.566E-11, 1.623E-11, 1.408E-11, 1.317E-11, 1.347E-11, 1.424E-11, 1.731E-11, 1.974E-11, 2.076E-11, 2.226E-11, 2.413E-11, 2.036E-11, 2.069E-11, 1.962E-11, 2.018E-11, 1.960E-11, 2.105E-11, 2.335E-11, 3.616E-11, 5.313E-11, 6.854E-11, 6.889E-11, 6.477E-11, 4.389E-11, 3.886E-11, 9.920E-11, 8.612E-11, 7.572E-11, 6.997E-11, 4.466E-11, 5.707E-11, 6.366E-11, 6.267E-11, 5.676E-11, 5.845E-11, 6.801E-11, 7.602E-11, 6.727E-11, 4.275E-11, 7.192E-11
6.551E-11, 5.921E-11, 4.692E-11, 4.535E-11, 4.979E-11, 2.281E-11, 2.268E-11, 2.656E-11, 2.843E-11, 2.364E-11, 1.690E-11, 1.886E-11, 1.715E-11, 1.579E-11, 1.678E-11, 2.038E-11, 2.496E-11, 3.008E-11, 3.065E-11, 2.266E-11, 2.633E-11, 2.536E-11, 3.013E-11, 3.116E-11, 3.126E-11, 2.317E-11, 2.140E-11, 1.891E-11, 1.761E-11, 1.582E-11, 1.424E-11, 1.038E-11, 7.138E-12, 1.186E-11, 1.291E-11, 1.366E-11, 1.651E-11, 1.985E-11, 2.043E-11, 2.345E-11, 2.383E-11, 4.049E-11, 5.996E-11, 5.333E-11, 5.833E-11, 5.696E-11, 5.673E-11, 3.928E-11, 4.188E-11, 5.622E-11, 5.735E-11, 6.518E-11, 5.162E-11, 5.739E-11, 5.780E-11, 4.824E-11, 1.257E-10, 2.871E-10, 2.826E-10, 2.352E-10, 1.745E-10, 1.396E-10, 1.183E-10, 1.065E-10, 8.428E-11, 7.596E-11, 5.959E-11, 6.573E-11, 7.221E-11, 7.877E-11, 8.891E-11, 7.333E-11
2.268E-11, 2.217E-11, 1.708E-11, 1.763E-11, 1.614E-11, 1.555E-11, 1.691E-11, 1.381E-11, 1.596E-11, 2.180E-11, 2.050E-11, 2.550E-11, 2.400E-11, 2.394E-11, 3.271E-11, 4.878E-11, 4.973E-11, 5.691E-11, 5.839E-11, 5.814E-11, 5.632E-11, 5.485E-11, 4.580E-11, 3.923E-11, 3.870E-11, 4.029E-11, 4.325E-11, 2.782E-11, 1.929E-11, 1.596E-11, 1.400E-11, 1.617E-11, 2.230E-11, 1.569E-11, 1.526E-11, 1.863E-11, 1.949E-11, 2.221E-11, 2.774E-11, 3.314E-11, 2.551E-11, 4.103E-11, 7.004E-11, 5.820E-11, 7.134E-11, 7.004E-11, 7.551E-11, 7.729E-11, 7.098E-11, 6.835E-11, 6.728E-11, 6.386E-11, 7.560E-11, 8.878E-11, 8.861E-11, 6.101E-11, 6.701E-11, 7.625E-11, 7.595E-11, 9.824E-11, 1.231E-10, 1.383E-10, 1.901E-10, 2.170E-10, 1.921E-10, 1.635E-10, 1.745E-10, 1.204E-10, 6.767E-11, 4.562E-11, 3.851E-11, 3.200E-11
1.576E-11, 1.126E-11, 9.244E-12, 1.056E-11, 1.437E-11, 1.574E-11, 1.454E-11, 1.153E-11, 9.733E-12, 7.882E-12, 8.077E-12, 8.440E-12, 1.150E-11, 2.244E-11, 4.781E-11, 8.382E-11, 8.484E-11, 6.330E-11, 5.607E-11, 8.103E-11, 6.331E-11, 4.353E-11, 3.883E-11, 4.183E-11, 4.201E-11, 4.577E-11, 4.591E-11, 4.753E-11, 4.603E-11, 3.345E-11, 2.623E-11, 2.157E-11, 2.150E-11, 1.956E-11, 2.766E-11, 2.996E-11, 3.142E-11, 2.835E-11, 3.467E-11, 3.064E-11, 2.672E-11, 4.028E-11, 5.445E-11, 5.291E-11, 5.798E-11, 7.277E-11, 6.335E-11, 5.300E-11, 6.353E-11, 8.124E-11, 7.548E-11, 6.858E-11, 8.042E-11, 7.784E-11, 6.970E-11, 5.434E-11, 5.468E-11, 5.178E-11, 5.768E-11, 6.343E-11, 5.659E-11, 8.026E-11, 1.233E-10, 8.233E-11, 6.897E-11, 6.295E-11, 5.036E-11, 4.536E-11, 3.550E-11, 4.720E-11, 4.691E-11, 2.533E-11
1.358E-11, 1.361E-11, 1.446E-11, 1.422E-11, 1.209E-11, 7.732E-12, 7.464E-12, 7.643E-12, 7.636E-12, 7.621E-12, 7.406E-12, 8.763E-12, 1.080E-11, 1.832E-11, 3.837E-11, 4.580E-11, 4.208E-11, 5.369E-11, 5.087E-11, 6.967E-11, 5.195E-11, 4.600E-11, 3.824E-11, 3.963E-11, 4.864E-11, 4.438E-11, 4.409E-11, 2.548E-11, 2.461E-11, 2.298E-11, 2.313E-11, 1.940E-11, 2.158E-11, 2.159E-11, 2.366E-11, 3.272E-11, 3.594E-11, 3.020E-11, 3.214E-11, 3.381E-11, 5.117E-11, 5.071E-11, 4.259E-11, 4.312E-11, 4.348E-11, 3.965E-11, 4.800E-11, 5.984E-11, 6.510E-11, 6.526E-11, 7.663E-11, 7.748E-11, 7.521E-11, 8.425E-11, 5.404E-11, 4.667E-11, 4.826E-11, 4.475E-11, 3.845E-11, 4.897E-11, 5.326E-11, 6.536E-11, 7.679E-11, 5.781E-11, 6.765E-11, 7.236E-11, 6.310E-11, 7.985E-11, 5.274E-11, 2.686E-11, 2.105E-11, 1.760E-11
9.480E-12, 8.803E-12, 8.828E-12, 1.177E-11, 1.061E-11, 8.029E-12, 7.398E-12, 6.641E-12, 6.452E-12, 6.361E-12, 5.762E-12, 6.815E-12, 9.988E-12, 1.705E-11, 2.292E-11, 3.086E-11, 5.007E-11, 3.412E-11, 4.899E-11, 6.355E-11, 5.651E-11, 5.126E-11, 4.532E-11, 3.622E-11, 3.538E-11, 3.784E-11, 3.547E-11, 2.504E-11, 1.815E-11, 1.291E-11, 1.221E-11, 1.114E-11, 1.406E-11, 1.530E-11, 1.689E-11, 2.105E-11, 2.945E-11, 3.103E-11, 3.151E-11, 3.300E-11, 4.371E-11, 3.720E-11, 3.817E-11, 3.067E-11, 3.039E-11, 3.708E-11, 4.733E-11, 4.744E-11, 5.461E-11, 5.492E-11, 4.872E-11, 4.809E-11, 6.303E-11, 5.104E-11, 4.265E-11, 3.416E-11, 2.741E-11, 3.619E-11, 3.770E-11, 3.891E-11, 3.485E-11, 3.827E-11, 3.051E-11, 2.288E-11, 3.336E-11, 4.442E-11, 4.140E-11, 3.699E-11, 2.872E-11, 3.016E-11, 1.932E-11, 1.087E-11
9.660E-12, 1.115E-11, 1.870E-11, 5.319E-11, 8.000E-11, 3.304E-11, 1.225E-11, 7.440E-12, 6.357E-12, 6.377E-12, 6.463E-12, 6.836E-12, 8.203E-12, 1.250E-11, 1.631E-11, 2.018E-11, 2.159E-11, 2.291E-11, 2.496E-11, 3.133E-11, 4.714E-11, 4.392E-11, 3.720E-11, 3.124E-11, 2.402E-11, 2.220E-11, 2.385E-11, 1.424E-11, 1.229E-11, 1.286E-11, 2.090E-11, 2.290E-11, 1.267E-11, 9.333E-12, 9.929E-12, 1.428E-11, 1.935E-11, 2.611E-11, 3.359E-11, 3.931E-11, 5.082E-11, 4.901E-11, 4.739E-11, 4.933E-11, 5.238E-11, 3.733E-11, 4.047E-11, 5.082E-11, 6.113E-11, 6.845E-11, 7.096E-11, 6.455E-11, 5.856E-11, 5.471E-11, 3.751E-11, 2.988E-11, 3.545E-11, 4.604E-11, 2.859E-11, 2.576E-11, 2.627E-11, 2.774E-11, 3.161E-11, 3.263E-11, 4.788E-11, 6.214E-11, 4.367E-11, 2.513E-11, 1.674E-11, 1.410E-11, 1.388E-11, 1.172E-11
7.301E-12, 9.607E-12, 2.699E-11, 5.120E-11, 2.633E-11, 1.737E-11, 1.170E-11, 9.242E-12, 6.824E-12, 7.117E-12, 7.068E-12, 7.629E-12, 8.515E-12, 8.777E-12, 9.555E-12, 1.414E-11, 2.129E-11, 2.891E-11, 2.439E-11, 2.205E-11, 2.478E-11, 3.504E-11, 3.311E-11, 2.114E-11, 1.405E-11, 1.537E-11, 2.434E-11, 3.622E-11, 3.890E-11, 3.841E-11, 3.182E-11, 2.185E-11, 1.859E-11, 1.905E-11, 1.603E-11, 1.570E-11, 1.715E-11, 1.880E-11, 2.241E-11, 2.612E-11, 2.741E-11, 3.207E-11, 3.996E-11, 4.851E-11, 5.739E-11, 5.696E-11, 5.552E-11, 5.137E-11, 5.036E-11, 3.954E-11, 3.681E-11, 3.763E-11, 3.739E-11, 3.590E-11, 3.377E-11, 3.383E-11, 3.101E-11, 2.641E-11, 2.269E-11, 1.966E-11, 2.262E-11, 2.436E-11, 2.407E-11, 2.328E-11, 2.181E-11, 1.949E-11, 1.604E-11, 1.381E-11, 1.494E-11, 1.266E-11, 1.093E-11, 8.722E-12
8.795E-12, 8.906E-12, 9.493E-12, 1.245E-11, 1.425E-11, 1.185E-11, 9.868E-12, 9.321E-12, 9.326E-12, 9.210E-12, 9.070E-12, 1.014E-11, 1.115E-11, 1.122E-11, 1.128E-11, 1.139E-11, 1.189E-11, 1.385E-11, 1.609E-11, 1.674E-11, 1.676E-11, 1.497E-11, 1.437E-11, 1.405E-11, 1.490E-11, 1.546E-11, 1.615E-11, 2.611E-11, 2.666E-11, 2.613E-11, 2.493E-11, 2.591E-11, 2.736E-11, 2.732E-11, 2.297E-11, 1.771E-11, 1.234E-11, 1.057E-11, 1.252E-11, 1.808E-11, 2.220E-11, 2.539E-11, 2.835E-11, 3.211E-11, 3.494E-11, 3.591E-11, 3.416E-11, 3.095E-11, 3.120E-11, 2.668E-11, 2.192E-11, 2.328E-11, 2.703E-11, 2.915E-11, 3.282E-11, 3.665E-11, 3.555E-11, 2.101E-11, 2.011E-11, 2.313E-11, 2.512E-11, 2.419E-11, 2.586E-11, 2.502E-11, 1.472E-11, 1.402E-11, 1.419E-11, 1.413E-11, 1.275E-11, 1.150E-11, 1.146E-11, 9.015E-12
1.507E-11, 1.474E-11, 1.634E-11, 1.782E-11, 1.760E-11, 1.681E-11, 1.677E-11, 1.698E-11, 1.676E-11, 1.593E-11, 1.577E-11, 1.548E-11, 1.419E-11, 1.204E-11, 1.024E-11, 9.184E-12, 8.583E-12, 8.522E-12, 9.036E-12, 1.110E-11, 1.307E-11, 1.344E-11, 1.338E-11, 1.344E-11, 1.670E-11, 2.195E-11, 2.229E-11, 2.231E-11, 2.226E-11, 2.198E-11, 1.911E-11, 1.622E-11, 1.549E-11, 1.192E-11, 1.149E-11, 1.151E-11, 1.150E-11, 1.219E-11, 1.325E-11, 1.487E-11, 1.629E-11, 1.676E-11, 1.624E-11, 1.521E-11, 1.572E-11, 1.699E-11, 1.744E-11, 1.861E-11, 1.973E-11, 2.077E-11, 2.269E-11, 2.591E-11, 2.803E-11, 2.949E-11, 2.888E-11, 2.704E-11, 2.648E-11, 2.626E-11, 2.791E-11, 3.314E-11, 3.745E-11, 3.218E-11, 2.408E-11, 1.890E-11, 1.661E-11, 1.510E-11, 1.357E-11, 1.222E-11, 1.314E-11, 1.629E-11, 1.834E-11, 1.660E-11
2.899E-11, 2.653E-11, 2.558E-11, 2.395E-11, 2.243E-11, 2.016E-11, 1.853E-11, 1.804E-11, 1.761E-11, 1.761E-11, 1.758E-11, 1.713E-11, 1.551E-11, 1.519E-11, 1.530E-11, 1.552E-11, 1.536E-11, 1.465E-11, 1.313E-11, 1.214E-11, 1.140E-11, 1.116E-11, 1.162E-11, 1.295E-11, 1.442E-11, 1.535E-11, 1.563E-11, 1.413E-11, 1.296E-11, 1.162E-11, 1.083E-11, 1.043E-11, 1.058E-11, 1.051E-11, 1.092E-11, 1.208E-11, 1.252E-11, 1.321E-11, 1.403E-11, 1.545E-11, 1.644E-11, 1.621E-11, 1.574E-11, 1.579E-11, 1.564E-11, 1.541E-11, 1.493E-11, 1.462E-11, 1.471E-11, 1.474E-11, 1.507E-11, 1.936E-11, 2.389E-11, 2.424E-11, 2.451E-11, 2.583E-11, 2.767E-11, 2.861E-11, 2.778E-11, 2.431E-11, 2.080E-11, 2.018E-11, 2.119E-11, 2.584E-11, 3.037E-11, 3.189E-11, 3.363E-11, 3.360E-11, 3.313E-11, 3.255E-11, 3.211E-11, 3.146E-11
1.739E-11, 1.738E-11, 1.736E-11, 1.724E-11, 1.684E-11, 1.662E-11, 1.672E-11, 1.674E-11, 1.668E-11, 1.661E-11, 1.658E-11, 1.656E-11, 1.660E-11, 1.641E-11, 1.611E-11, 1.562E-11, 1.513E-11, 1.477E-11, 1.430E-11, 1.403E-11, 1.365E-11, 1.338E-11, 1.306E-11, 1.282E-11, 1.263E-11, 1.257E-11, 1.274E-11, 1.285E-11, 1.317E-11, 1.379E-11, 1.529E-11, 1.730E-11, 1.868E-11, 1.975E-11, 2.015E-11, 2.040E-11, 2.103E-11, 2.115E-11, 2.109E-11, 2.086E-11, 2.075E-11, 2.082E-11, 2.062E-11, 1.994E-11, 1.855E-11, 1.754E-11, 1.735E-11, 1.755E-11, 1.827E-11, 1.868E-11, 1.911E-11, 1.969E-11, 1.993E-11, 2.007E-11, 1.972E-11, 1.946E-11, 1.897E-11, 1.855E-11, 1.838E-11, 1.854E-11, 1.847E-11, 1.830E-11, 1.778E-11, 1.756E-11, 1.738E-11, 1.726E-11, 1.724E-11, 1.719E-11, 1.726E-11, 1.726E-11, 1.728E-11, 1.731E-11
1.697E-11, 1.693E-11, 1.687E-11, 1.681E-11, 1.674E-11, 1.654E-11, 1.645E-11, 1.636E-11, 1.626E-11, 1.616E-11, 1.596E-11, 1.586E-11, 1.577E-11, 1.566E-11, 1.555E-11, 1.545E-11, 1.534E-11, 1.525E-11, 1.566E-11, 1.560E-11, 1.554E-11, 1.548E-11, 1.543E-11, 1.537E-11, 1.532E-11, 1.528E-11, 1.524E-11, 1.521E-11, 1.519E-11, 1.517E-11, 1.516E-11, 1.523E-11, 1.523E-11, 1.524E-11, 1.525E-11, 1.527E-11, 1.513E-11, 1.515E-11, 1.515E-11, 1.515E-11, 1.515E-11, 1.513E-11, 1.513E-11, 1.512E-11, 1.511E-11, 1.512E-11, 1.512E-11, 1.513E-11, 1.515E-11, 1.516E-11, 1.519E-11, 1.521E-11, 1.537E-11, 1.540E-11, 1.545E-11, 1.551E-11, 1.560E-11, 1.589E-11, 1.602E-11, 1.618E-11, 1.635E-11, 1.654E-11, 1.673E-11, 1.691E-11, 1.707E-11, 1.719E-11, 1.729E-11, 1.735E-11, 1.738E-11, 1.739E-11, 1.721E-11, 1.719E-11